%%%%% %%%%%
%         %
% %%%%% % %
% % %   % %
% % % %%%%%
%   %     %
%%% %%%%%%%
% %       %
% %%%%%%% %
%         %
%%%%% %%%%%