%%%%%%%%%%%%%%%%%%%%%%%%%%%%%%%
%     P   %         %     %   %
% % %%%%% % %%% %%% % %%% % % %
% % %     %   %     %   %   % %
% % % %%%%%%% %%%%% %%% %%% % %
% %   %       %   %   %   %   %
% %%% % % %%%%% % %%% % % %%%%%
%     % % %     %   % % %     %
% %%%%% % % %%%%%%% % % %%%%% %
%     % %           % % %   % %
%%%%% % %%%%%%%%%%%%% % % % % %
%   % %             % % % %   %
% % % %%%%%%% %%%%% % % % %%% %
% % % %   %   %     %   % %   %
% % % % % % %%% %%%%%%%%% % %%%
% % %   %   %   %       %     %
% % %%%%%%% % %%% %%%%% %%%%% %
% % %     % %     %     %     %
% % % %%% % %%%%%%% %%%%% %%% %
% %   %             %         %
% %%%%% % %%%%%%%%%%% %%%%%%%%%
% %   % % %           %       %
% % % % % % % %%% %%%%% %%%%% %
%   % % % % % %   %     %   % %
%%%%% % % % % % %%% %%% % % % %
%   % %   %   % %   %   % % % %
% % % %%%%%%% % % % % %%% % % %
% % % %       % % % % %   % % %
% % % % %%%%%%% % % % % %%% % %
%     %    *      %   %       %
%%%%%%%%%%%%%%%%%%%%%%%%%%%%%%%