%%%%%%%%%%%%%%%%%%%%%%%%%%%%%%%%%%%%%%%%%%%%%%%%%%%%%%%%%%%%%%%%%%%%%%%%%%%%%%%%%%
%P  % % % %  % % %   %  %   % %  %   % %   %  %  %  % %  % % % %   %   %  %  %   %
%   % % % % %  %   % %   %%       %     %    %  % %      %   %    % % %  %  %%  %%
%%  % %   %       %     %  %    %% %%%%  %  % %   %%%%  %   %   %%    %  % % % % %
% %   % %%%%%%  %% %% %%  % %    % %  %%   %   % %%  % %   %   %     %  %  % %   %
%  %  %   %    % %     %  %  %%  %  %     %    %  %    % %%   %  %%%%%  % %  % %%%
%   %  %% %  %%  % %%    %  %  %     %%  % %  % %  %% %   %  %  % %  % %    %    %
%%% %  %    % %%     %%     %   %   %   %    %   %    %  %  %       %  %  %%%  %%%
%    %   % %  % %%   % %%   %  % %  %  % %  % % % %  %  %  % % % % %% %     % %  %
%%    %  %% % % % %%   % %%   %%  %   %    %      %  % %  %  %  %   % %%% %%%    %
% %%    % %   %     %%   % %%   %   %%  % %     %% %   % %    % %  %  %     % %%%%
% % % %%  %    %% %   %%     %%    % % %      %%      %   %      % % %  %%%%%  % %
%    %  % %%%  %   % %  %%     %% %    %%   %% %     %   %%   %%%%%  % %  % %  % %
% %%  %   %  % % %  %   % %% %   %  %%   %%    %   %% %% % %  %%  % %       % %  %
%%     %       %%  %   %  % %%  % %% %     %%   %%  % %  %  %    %  % %  %%%%   %%
%  % %  %%  %  %  %  %%  %     %  %      %%  %%    %   %     %  %  %  %%%   % %  %
% %%% %   %  %%%      %%  %   %  % % % %%    % %% %  %  %   %%     %  %%    %  %%%
%%  %  %%  %  % %%%  % %  %  % %   %  %  %  %  % %  %% %%  %  %  %%  % %   % % % %
% %    % %  %   %%  %  %%   %   %%  %  %   %  %  %%   %  %   % % %% %    % % %   %
%   %  %  %  %     % %     % %  % % %  %  % %   %  %      %% %    % %  % %%%  %  %
% %%  %    %  %%  %   %%  %    %  %  %   %   % %  % %  %% %    %%%     %%  % % % %
%% %  %%%%   %% %   %%%  %  %       %%  %      %%    %  %% % %%  %% % %    %   % %
%  % %  %% %  %  %      %    %% %% %  % %     %  %%   %  % %  % %   %%   %%% %%% %
%%   %    %  %    % %%   % %   %   %  %   %% % % % %   %    %   % %%   %%  %   % %
%   % %    %   %  %   %   %   %   %    %%   %    %  %   %  % % %     %    %%  %  %
%%  %  %  %  %% %  %   %     %   %  %% %  % % %  %   %%  %     %  %   %  % %% %  %
%  %    %   % %  %   %%  %  % %%   %%   %  %   %   %%% %  %   %  % % %% %  %  % %%
%% %%%%   %%  %%   %% % %% %  % %    %    %    %  %  %  %  %  %%   %   %   % %%  %
%        %  % %  %% %     % %    %%  %%% % %    %%    %  %  % % %%  % %  % %    %%
%% %%  %% %     % %   % %%  % %  % %%    % %   %    % % %   %     %  % %  %   %% %
%  %  %     % %%   %  %  %%  %  %% % %  %    %% %  %    % %   %  %  %    %% %%   %
%  % % %%   %% % %   %  %  % %   %     %    % % % %   %%   %   %   %   %% % %% %%%
%% %%      % %  %   %  % %    %    % %% %  %     %     %%   %   % %  %%   % %%   %
% %  % % %%  %   % %  %    % %% %  %  %  %        % % %  %  % %  %  %%   %% %   %%
%  %   %% %   %   %  %    %    %%%%  %  % %%    %  %  %   %  %  %       % % %  % %
%% % %%    %% % %   % %% %   % %    %     %    %   %    %   %  %  %  % %  %   %  %
%   %    % %% %%   %    %% %%   %% % % %   % %% %   %   %  %  %  %%   %  %  %   %%
% %  % % % %  %   % %       % % %  %    %   %    %   % %  %  % %   % %     %%%%  %
%%    %  %  % %  %   %  %  %  %   % %  % %   %  % % %% % %  %   %   %  % %%    %%%
%  %%  % %  %   %    % %  %   %  %   %    %   %        %%  %       %    %    %%  %
%%%     %% %%  % %    %  %   %      %%   % %   % % % %%   %     % %  % %  % %    %
%    %% %  %  %  % %%   %   %    %    %     %     %%%    %  %%   %   %%   %%  % %%
%  %%    % %  %   % %  % % % %% %% %%  %  %  %  %% %  % %     % %   %   %%     % %
%%% %  %     %  % %    % % % %   %% %%  % %   %%    %  %   %%  %   %   % %  %  % %
% %   %  %  % % %  %  %   %    %% % %  %%  %% %   %   %  % %  %   %  %%   % % %  %
% % %% % % %   %  %% %   %%  %%       %  %   % % %   %    %  %  %   %        %  %%
%  %     %%         %  %   %% % %%   %    %     %   %  %%%% %  % %  %%  %   %    %
%  %  %  %  % %  %% %  %% %%  % % %% % % % %%%   % %       %      % %  %  %    %%%
%%  %%  %  %  % % %  %%   % % %     %  %   %   %  % %%  % %  %  % %   %    %%%   %
%   %%% %%  % %%    %%   %  % %%   % %%     % %  %  % %  %  %   %  %  % %     %% %
% %     %  %%% %  % % % %%%   %%  %    %  %  %  %       %  %  % %   %%  % %%    %%
%%%%  % %% %   % %%   %     %    %  %%   %     %   % % %  %    %     % %%  %  %  %
%    %  %  %%%  %   %  %  %  %  %     % %  %%% % %  %%%  %    %  %  %    %  %  % %
%  %%   %% %  %   %%   % %    % %%% %  %      %  %%   %  %%  %    % % %   %  %  %%
% %    % %  %   %%   %  % %   %  %  %% %%   % % % %     %   %   %  %   %  %  %%% %
%%  %  %    % %%   %  %%%    % %  %   %    %  % %  % % %  %%  % % %  %  %  %%    %
%  % % %% % %%   %  %    % %    %  % %   %%  %  %     %    %%  %  %   % %%%    % %
% %    % %%%   %%%%  % %  %  % %%    % % %%  % % %  %  %  %   %  %   %%% %  %   %%
%%     %    %%%%      %   %  %%  %  %  %   %%  %  %% %  %%   %   % %%     %  %   %
%  % % %%%      %%% %  %%  %     % %    %   %  %%         % %  %%      %%   % % %%
%%  %%% %  % %   % %%% %%% %  %   %  %   %    %   %%%%%%%  %    % % %    %%    % %
% %   %  % %%  %      %%%   %  %  %%%%%%%%%%%%%%%%      %   %  %  %%% %%   %% %  %
%   % %   %     %  %   % %% %  % %    % %          %% % %%   % % % % %%      %  %%
%  %  %%   %%%   %%   %   %  %  %   %     % % %  %   %%   %   %%       %%%  %  % %
% %   %  % %   % %  %%  %%%  % %  %  %   %  %  %  %    %%       % % %%    %%     %
%%    % %   % %   %  %    %%  %% %%%  % %   %   %  %%    %% % %  %    %    % %  %%
%    %  % %  %    % %   % %  %%    %%  %   %  % %    %  %  %% %   %   %   %  %%% %
%%   %  % %   %    %  %%  %%   %  %    % %%% %%  %    %      %%% % %%  % %       %
%    % %  %%% % % %    % %  % %% %  % %    %   %  % %  %   %   %     %  %   %  % %
%%   % % % %   %    % %  %    % %    %  % %     %  %    % %   %   %   %   %  % % %
%  % % %%    %% %%% %%   %%% %  % % %   %%% % %  %  % %  %%  %  %%%    %   %%%%%%%
%%%  % %    %   %    %%  %   %%  %  %     %%  %%  %  %     % %   % %%   %%       %
%   %  %%% %   % %  %   %%% %    % %    %%   %     %  %     %  %     %    %   %% %
%%  % %        %  % %    %  %% %  %   %  % % %%     %  %    %   %  %  %%   %   % %
%   % %  %%%  %    %  %       %%%  %%  %%  %%    %   %  %  %  %  % %%   %%  %  % %
%%  % % %    %   % %   % %  %    %      %%  % % %  %  %  % %  %%  %%  %   %  % % %
% % % %%  % %   %   %   %% %  %    %%%  %% %  %%   %%  %  %     %  %  % %  %  %% %
%   % %  %  %  %  %  %%   %    % % %   %   %   % %%    %   %  %  %  % % %%  %   %%
%  %  % %% %  %    %     %  %   %  % % %% %   %   %% %  %   %  %  %%% %   %  %   %
%% % %  %    %  % %  %  %  %  %  % %%  %  %  %    %   %  %   %  %   % %    %  %  %
%  % %  % % %  %  % %  %*  %  %   %   %    % % % %  %  %  %   %  %  % % %   %  % %
%%%%%%%%%%%%%%%%%%%%%%%%%%%%%%%%%%%%%%%%%%%%%%%%%%%%%%%%%%%%%%%%%%%%%%%%%%%%%%%%%%
