%%%%%%%%%%%%%%%%%%%%%%%%%%%%%%%%%%%%%%%%%%%%%%%%%%%%%%%%%%%%%%%%%%%%%%%%%%%%%%%%%%%%%%%%%%%%%%%%%%%%%%%%%%%%%%%%%%%%%%%%%%%%%%%%%
%   %    P    % %               % %     %       %     %   % %     %     % %     %       %       % %     % %   % %         %     %
% % % % %%% % % %%%%% % % %%%%% % % % % % %%%%% % %%% % % % % % % % % %%% %%%%% % %%%%% % % %%%%% % %%% % % % % % %%% %%% % %%% %
% % % % % % % %     % % % % %   %   % % %   %       %   %   % % % % %     %   %   %     % %     %   %   %   %   % %   % %   %   %
%%% % % % % % % % % % %%% % % %%% %%% %%%%% %%%%%%% %%% % %%% %%% % %%% % % % % %%% %%%%% %%%%% % %%% %%%%%%%%% % %%% % %%%%% %%%
% %   % % % %   % % %   %   %   % %     % %     % %   % %   %   % % %   % % %   %   %         % % %   % %   %       % % %   %   %
% %%%%% % % %%% %%% %%% %%%%%%% % % %%% % %%% % % %%% % % % %%% % % % %%% % %%%%% % % % %%%%% % % %%%%% % % % %%% % %%% % % %%% %
%       %   %   %       %       % %   %       % %     % % %     %   %   %       % %   % %     %         % %     % %     % %     %
%%%%%%%%%%%%%%%%% %%%%%%%%% %%%%% %%%%%%%%%%% %%%%%%%%%%%%%%%%%%% %%%%%%%%%%%%%%%%%%%%%%% %%%%%%%%%%%%% %%% %%%%%%% %%%%%%%%%%%%%
% %     %         %     %     % %     % %       %       %   %   %       %       %   % % %       %   %   %       %       %   %   %
% % % %%%%% %%% % % %%% % %%% % % %%% % % %%%%% % %%%%% % % % %%% %%%%% % %%%%% % %%% % % % %%%%% % %%% %%%%%%% % %%%%% % % % %%%
%   % % %   % % %   %   %   % % % %   % % %   % % % %   % %   % %   %   % %     %   %   % %     % % %   %     % %     %   % %   %
% %%% % % %%% % % %%% %%%%%%% % % % %%% % % % % % % % %%% %%% % %%% % %%% %%%%%%%%% %%% %%% %%% % % % % % %%% % %%%%%%% % %%%%% %
%   % %   % %   % % %   %     %   % %   % % % %   %   %   %   % %   %   %     % %     % %     % % %   %     %   %   %   %     % %
%%% % % % % % %%% % %%% % % %%% % % % % % % %%% % %%%%% % % %%% % %%%%%%%%%%% % % %%% % % %%%%% % %%%%% % %%%%%%% % %%% %%%%% % %
%   %   %   %   % %     % %     % %   % % %     %       % %     %       %           %   %   %   %     % %       % %     %       %
%%%%%%% %%%%%%%%%%%%%%%%%%%%%%%%%%% %%%%%%%%%%%%%%%%%%%%%%% %%%%%%%%%%%%%%% %%%%%%%%% %%%%% %%%%%%%%%%% %%%%%%%%%%%%%%%%%%%%%%% %
%     % %       %       % %     %     % %     % % %   % %       %       %       % %     % %     %       %       %   %   % %     %
% %%%%% % %%%%% % %%%%% % % %%% % % % % %%% % % % % %%% %%% %%% % %%%%%%%%%%%%% % % %%% % % %%% % %%%%% % %%%%%%% % % % % %%% %%%
%       % %   % %   %   % % %   % % %   %   % % %   %   %   %   %   %   %     % %   %   %   % % %     % % % %   % % % % %       %
% %%%%%%% % % % % % %%% % % % %%% % %%%%% %%% % % %%%%% % %%% %%%%% % % % % %%% % %%% %%%%%%% % %%%%%%% % % % % % % % % %%%%%%% %
%       %   % % % %   %   % %   % %     % %   %     %   %   % % % % % % % % %   %   %         % %     %     % % % % % % %     % %
%%%%%%% % %%%%% %%%%% % % % %%% %%%%%%% % %%%%% % % % %%% % % % % % % % % %%% % %%% %%% % % %%% %%%%% % % %%%%% % % % % % %%%%% %
%         %     %     % %   %   %       %       % %       % %   %     % %     % %   %   % %     %       %         %   % %       %
%%%%%%%%%%%%%%% %%%%%%% %%%%%%% %%%%% %%%%%%%%% %%%%%%%%%%%%%%%%%%%%% %%%%%%%%% %%%%%%%%%%%%%%%%%%%%%%%%%%%%%%%%% %%%%%%%%%%% %%%
% %     %     % %       %       % %   % % %       % %     %   % %   %         %     %   %       %       %       %       %       %
% % %%% % %%% % % %%% %%% % %%%%% % % % % % %%% % % % % % % % % % % %%% % %%% % % %%% % % %%%%% %%%%%%% %%% %%% % % %%%%% %%%%%%%
% % %   % %   % % % %   % %     %   %   %   %   % %   % %   %   % %     %   % % % %   % %     % %     % %     % % %     % %     %
% % % %%%%%%% % % % %%% %%% %%% %%%%%%% %%%%%%% % %%%%% % %%%%% % %%%%% %%%%% % % % %%% %%%%% % % % % % % %%%%% % %%%%% % % % %%%
%   % % %     %   %     %     % %   %   %       %   %   % %     % %   % % %   % % % %   %   % % % % % %   %         %   %   % % %
%%%%% % % %%%%% % %%%%%%% %%%%% % % % %%% %%%%%%% %%% %%% %%% %%% %%% % % % %%% % % % %%%%% %%% % % % % % %%%%%%% % %%% %%%%% % %
%               %       %   %   % %     %       %       %   %   %     % %       %   %           % % %   %       % %   % %       %
%%%%%%%%%%%%%%% %%%%%%%%%%%%%%%%%%%%%%%%%%%%%%%%%%%%%%%%%%%%%%%%%%%%%%%%%%%%%%%%%%%%%%%%%%%%%%%%%%%%%%%%%%%%%%%%%%%%%%%%%%%%%%%%%
%       %     % %       %   %   % % %   %   %   %           %   % % %           %   %     % %   %       %       %               %
% %%%%% % %%% % % %%%%% % % % % % % % % % % %%% % %%%%% % % % %%% % % % % %%%%%%% %%% % % % % % % %%%%% % % %%% %%%%%%% % %%%%%%%
% % %   %   %   % %     % %   % % %   % % %   % % %     % %   % % %   % % %     % %   % %   % % % % % %   % % % %     % % %     %
% % % % %%% %%% % %%%%%%% %%%%%%% %%%%% % %%% % %%% %%% %%%%% % % % %%% % % %%% % % %%% % %%%%% % % % % %%% % % %%% % % % %%%%% %
%   % %     % % % %         %   %   %   % % % %     %   %     % % % %   %   % % %   %   %       % %   % %   % % %   %   %   %   %
%%% % % % %%% % % % %%% %%% % % % %%% %%% % % % % %%% %%% %%%%% % %%% % %%% % % % %%% %%%%%%%%% % %%% % % %%% % % %%%%%%%%% % %%%
%   % % %     %     %   %     % %           %   %   %   %       %     % %   %   % %     %       %   %   %     % %       %       %
%%%%%%% %%%%%%%%%%%%%%%%%%%%%%%%%%%%%%%%%%% %%%%%%%%%%%%%%%%%%%%% %%%%%%%%%%%%%%%%%%%%% % %%%%%%%%% %%%%% %%%%%%%%%%%%% % %%%%%%%
%       %   %   %   %   %   % % %       %   %       %   %     % %     %         %     % %   %   %   %   % %   % %       %       %
%%%%%%% % % % % % % % % % %%% % % %%%%% %%% % % % %%% % %%% %%% % %%%%% % %%%%% % %%%%% %%% %%% %%% % %%% % % % %%%%%%% % %%%%%%%
%       % % % % % %   % % %   % %   % % %   % % % %   % %   %   % %   % % % %     %   % % %   % %   %   %   % % %       %       %
% %%%%%%% %%% % %%%%%%% % % %%% % %%% % % % % % % % %%% % %%%%% % % % % % % % %%% % % % % %%% % % % % %%%%%%% % % % %%% % %%%%% %
%   %     %   % %     %       % % %   % % % % % %   %     %   %     % % % %   % % % % % %   %   % % %   %     % % % % % % % % % %
%%% % %%% % %%%%% %%% % %%%%% % % % %%% % %%% % % %%%%%%% % % % %%%%% % % %%%%% % % % % % %%% % % % %%% % %%%%% % %%% % % % % % %
%       %           %   %       % %           % %       %   %   %       %       %   %   %     % % %     %             % %     % %
%%% %%%%%%%%%%%%%%%%%%%%%%% %%%%%%%%% %%%%%%%%%%%%%%%%%%% %%%%%%%%%%%%%%%%%%%%%%%%%%%%%%%%%%% %%%%%%%%% %%%%%%%%%%%%%%%%%%% %%%%%
%   %   %               %   %   %   %   %       %   %   %       % %   % %   %   %     % %       %       % % %   % %   % % %     %
%%% % % % %%%%% % %%%%% % %%%%% % % %%% % %%%%% %%% % %%%%%%% %%% % % % % % % % % % % % %%% %%% % %%% %%% % % % % %%% % % % % % %
%   % % %     % %   % % %       % %   % % %   % %   %   %       %   %   % %   % % % % %   %   % % %     % % % % % %     %   % % %
% %%%%% %%%%% %%%%% % % % %%%%%%% %%%%% % % % % % %%%%% % %%%%%%% % %%%%% %%%%%%% %%% % % %%%%% %%%%%%% % % % % % % %%% % %%% %%%
% %   % %   %   % % %   % %     % %     % % %     %       %     % %       %   % %   % % %       %     % % %   % %   %     %     %
% % %%% % %%%%% % %%% %%% %%%%% % % % %%% % %%%%% % %%% % % %%% %%%%%%% % % % % %%% % % %%%%%%% % %%%%% % %%%%% %%%%% %%% % %%%%%
%       %       %       %       %   %   % %     %   %   %   %   %       %   %   %   %   %       %       %               % %     %
%%% %%%%%%%%%%%%% %%%%%%% %%%%%%%%%%% %%%%%%%%%%%%%%%%%%%%%%%%%%% %%%%%%%%%%%%%%%%%%%%% %%%%% %%%%%%%%% %%%%%%%%%%%%% %%%%%%%%%%%
%     % %       %       % %   % %       %   %       %   %   %   %       %       %     % %   %   %     %     %   %   %   % % %   %
% %%% % %%% %%% % %%%%% % % % % %%%%%%% % % % % % % % % % % %%% % %%%%% % %%%%% % %%%%% % % %%% % %%% % %%% % % % % %%% % % % % %
%   %   %   %   % %   % % % %       %   % %   % % %   % % %     % %   %   %   % % %   % % %   %   % %   %   % % % % %   %   % % %
% % %%% % %%% %%% % % % % % % % % %%% %%% %%%%% % %%%%% % %%%%%%% %%% % % % %%% % % % % %%%%% % % % %%%%% %%% % %%% % %%% % %%% %
% % % %   % % % % % %   % % % % % %   % %     % % %   % % %     %   %   %   %   % % %   %     % % % %   % % % % %   %     %   % %
% % % % % % %%% % % %%%%% %%% % % % %%% %%%%% % %%% % % % %%%%% %%% % %%%%% %%%%% % % %%% %%%%% % % % % % % %%% % %%% % % %%% % %
% %   % %         %     %     % %             % %   %           %   %   %           %   %       %     % %       %     % %   %   %
%%%%%%%%%%%%%%%%%%%%%%%%%%%%%%%%%%%%%%%%%%%%%%%%%%%%%%%%%%%%%%%%%%%%%%%%%%%%%%%%%%%%%%%%%%%%%%%%%%%%% %%%%%%%%%%%%%%%%%%%%%%%%%%%
%       %       %   %           %       %       %     % %       %   %   %       %   %   % %     %   %       %     %     %   %   %
%%% %%% % %%%%% % % % % % %%%%% %%%%%%% %%%%%%% %%%%% % % %%%%% %%% %%% % %%%%% %%% % %%% % % % % % %%% % % %%% % % %%%%% % %%% %
%   % % % %   % % % % % % % %   %       %       %   % % % %     %       %   %   % % %   %   % % % %     % %   % % %   % % %     %
% %%% % % % %%% % % % % % % %%%%% %%%%% % %%%%%%%%% % % % % %%%%% %%%%%%% %%%%% % % %%% %%%%%%% % %%%%%%% %%%%% % % % % % %%% %%%
%   %   % %   % % %   % % %   % %   %   %           %     %     %       % %   % %   %   % %     %       %   %   % % % % % % %   %
%%% %%%%% %%% % % % %%% % % % % %%% % %%% %%%%%%% %%%%% %%%%% % %%%%%%% % %%% % % %%% % % % % %%%%%%%%% %%% %%% % % % % %%% %%% %
%           %   % % %   %   %   %   %   %       %       %     % %       %     %       % %   %   %       %       %   %   %       %
% %%%%%%%%% %%%%%%%%%%%%% %%%%%%% %%%%%%% %%%%%%%%%%%%%%%%%%% %%%%%%%%% %%%%% %%%%%%% %%% %%%%%%%%%%%%%%%%%%%%%%%%%%% %%%%%%% %%%
%       %       %       %     % %       %   % % %         %     %       %   %   % % %   % %   % %       %       %       %   %   %
% %%%%%%%%%%%%% % %%%%% % %%% % % %%%%% %%% % % % %%%%% % % %%% % %%%%%%% % % % % % % % % %%% % % %%%%% % %%%%% %%% % %%% %%% % %
%       %     % % % %   %   % % % %     %     % %   %   %   %   %       % %   % %   % % %     % % %         %   %   %   % %   % %
%%%%%%% % %%% % % % %%% %%% % % % %%%%%%% %%% % %%% % %%%%% %%% %%%%%%% % %%%%% % %%% % %%%%% % %%% %%%%%%% % %%% %%%%% % %%%%% %
%       %   % % % %   % % % % % %       % %   % %   %   %   % %     %   % %     % %   % %     % %     % % % %   % %   % %       %
%%%%% %%% %%% % % %%% % % % %%% %%% %%% % %%%%% %%%%% % % %%% % % % % %%% %%%%%%% %%%%% % %%%%% % %%% % % % %%% %%% % % %%%%%%% %
%       %   %         % %       %   %   %       %     % %     % % %     %       %       %       %   %   %   %   %   %   %       %
%%%%%%%%%%%%%%%%%%%%% %%% %%%%%%%%%%% %%% %%%%%%% %%%%%%%%%%% %%%%%%%%% %%%%%%%%%%%%%%% %%%%% %%%%%%%%%%% %%%%%%%%% %%%%%%% %%%%%
%       %       %   %   %   %   %   %   %       %       %   %   %       %     % %   %   %       %     %     %   %     % %       %
% %%% % % % %%% %%% % % % % % % % % %%% % % %%%%% % %%% % % % % % %%%%% % %%% % % % % %%%%%%%%% % %%% % % % % %%% %%% % % %%%%%%%
% % % %   %   %     % % % % % % % % %   % %   % % %   % % %   % % %     %   % % % % %   %     % %   % % % % %   % %   % %       %
% % % % %%%%% % % % %%% % % %%% % %%% % % %%% % %%%%%%% % %%%%% % % %%%%%%% % % % %%% % % %%% % %%% % % % %%%%% %%% %%% % %%%%% %
% % % % %   % % % % %   % % %   %   % % % % % % %       %   %   % %   %   % %   % %   %   %     %   %   %     % %   %         % %
% % %%% % %%% % % % % %%% % % %%%%% % % % % % % %%%%% %%%%% % %%% %%%%% % % %%% % %%%%% %%% %%% % % %%% %%%%% % % %%% % %%%%% % %
% %     %     % % %     % %     %     % %   %   %       %   %   %       %   %   %       %   %   % %   % %       %     % %     % %
%%% %%%%%%%%%%%%%%%%%%%%%%%%%%% % %%%%%%%%%%%%% %%%%%%%%%%% %%%%% %%%%%%% %%%%%%%%%%%%%%% %%%%%%%%% %%%%%%%%%%%%%%%%%%%%% %%%%%%%
% %     % %     % %     %       %     % %     % %   %           % %   % %       %     % %     % %       %   %           %       %
% % %%%%% % %%% % % %%% %%%%%%% % %%% % % % % % % % % % % %%% %%% % % % %%% % %%% %%% % %%% % % %%%%% % % %%%%% % %%% % % %%%%% %
% %     % % %   %     % %   %   %   %   % % %   % % % % %   %   %   %   %   % % %   % % %   % % %     % %       % %   % % % %   %
% % %%% % %%% %%%%%%% %%% % % % %%% %%% % %%%%% % % %%% %%% %%%%%%% %%% % %%% % %%% % % % %%% % % %%%%%%% %%%%% % % %%%%% % % %%%
% % %       %       %   % %   % %   % %   % %   % %   % % %     %   %   %   % % % % % %   % %   % %     % % %   % % %     % % % %
% %%% %%% % %%% % % %%% % %%%%% %%%%% % % % % %%% %%% % % % %%% % %%% %%% % %%% % % % % % % % %%% %%%%% % % % %%% % %%% % % % % %
%       % %     % %           % %       %   %   %   %   %   %   %   %   % %         %   %   %   %           %   % %     %   %   %
%%%%%%%%%%%%%%%%%%%%% %%%%%%%%%%%%%%%%%%%%%%%%% %%%%%%%%%%%%%%%%%%%%%%%%%%%%%%%%%%%%%%%%%%%%% %%%%% %%%%%%%%%%%%%%%%%%%%%%%%%%%%%
% % %   % %     % %     % %     % %     %       %   %   %       %     % %   %   %       %     % %   %   %       %     %         %
% % % % % % % % % % %%% % % %%%%% % %%% %%% %%% % % % % %%%%%%% % %%% % % % % % %%%%%%% %%% % % %%% % %%% %%%%%%% %%%%% % %%%%% %
% %   % %   % %   % %   %   %   %     % %   % %   %   % %     % % %     % % % % %     %   % %   %   %     %           % % % %   %
% % %%% % %%%%% % % %%%%%%% % % %%%%% % % %%% % % %%%%%%% %%%%% % %%%%%%% %%%%% % %%% % % % %%%%% %%%%% % % %%% %%%%% % % % % %%%
% %   % %   %   % %     %   % % %   % % % % %   %       % %   % %     %   %   % %   % % % %     %       % % % % % %   % % % %   %
% %%%%% %%% % %%% %%%%% % %%%%% % % %%% %%% %%% %%%%%%% % % % % %%% % % % %%% % %%% % % % %%%%% % %%%%%%% % % % % % %%% % % %%% %
%           %   %       %       % %     %       %           %   %   %   %           %   %       %       %   %   %       % %     %
%%%%% %%%%%%%%%%%%%%%%%%%%%%%%% %%%%%%% %%% %%%%%%%%%%%%%%%%%%%%%%%%%%%%%%%%%%%%%%%%%%%%%%%%% %%%%%%%%%%%%%%% %%%%%%%%%%%%%%%%%%%
%       %       %       % %     %       %     % % %     %   %   %   %   %       %       %       % %     %     % %       %       %
% %%%%% % % %%% % %%% % % % % %%% % %%% % %%% % % %%%%% % %%% %%%%% % %%%%%%%%% % %%%%% % %%% % % % %%% % %%% % % %%% %%% %%%%% %
% %   % % %   % % %   %     %   % % %   %   % % %   %   %   %   %   %           % % % %   % % % % % % % % %   % %   %   %     % %
% % % %%% %%% %%% % %%% %%%%%%% %%% % %%%%% %%% %%% % %%% % %%% % %%%%% % %%%%% %%% % % % % % % % % % % % % %%% %%%%%%% %%%%% %%%
% % %   % %   % % % %   %       % % %   % %     %   %     %   % % %     %     % %     % % % % % %   %   % %     %   %         % %
% %%%%% % % %%% % % %%%%% %%%%%%% % %%% % % %%% % %%%%% % %%% % % % %%% %%%%%%% % %%%%% % % % %%% %%%%%%% %%%%%%% %%% % % %%%%% %
%       % %     % %     %       %   %   %   %   %       %   %   %   %   %               %   %   %       %       %     % %       %
%%% %%%%%%%%% %%%%%%%%% %%%%% %%%%%%%%% %%%%%%% %%%%% %%% %%%%%%% %%%%%%%%%%%%%%%%%%%%%%%%%%%%%%%%%%% %%%%%%% %%%%%%%%% %%% %%%%%
%   %   %       %   %   %       %       % %     %       % %     %   %   % %     %       %       %       %   %   %       %   %   %
% % % %%% % %%%%% %%% % % %%%%% % %%% %%% % %%% % %%%%% % % %%%%% % %%% % % %%% % %%%%% % %%% %%% %%%%% % % % %%% %%% % % % %%% %
% %   % % %     % %   % %     %   %   % % % %   %   %   %   %   % %     % %   %       % %   % % % %   % % % %   % % % % % %     %
%%% %%% % %%%%% % %%%%% %%% % %%% % %%% % % % %%%%%%% % % %%% % % %%%%%%% %%% % %%% % % %%% %%% % % % % % %%%%% % % % %%% %%%%%%%
%   %         %   %   % %   %   % % %   %   % %     % % %     % %   %   %     % % % % % %   %   %   % % %       % % %   %       %
% %%% % %%%%%%% % % % % %%%%%%% % %%% %%% %%%%% % %%%%% % %%%%% % %%% % %%%%%%% % % % %%% %%% % %%%%%%% %%%%%%% % % %%% % %%%%% %
%     % %       %   %   %       %       %       %       %     % %     %         %   %   %     % %       %         %     % %     %
%%%%%%%%%%%%%%%%%%%%%%%%%%%%%%% %%% %%%%%%%%%%%%%%%%%%%%% %%%%%%%%%%%%%%%%%%%%%%%%%%%%% %%%%%%% % %%%%%%%%%%%%%%%%%%%%%%%%% %%%%%
%   %     %     %         %     %   %   %   %   %       %       % %     %     % %   %   % %     %         %             %   %   %
% % %%% % % %%% %%% %%% % % % %%% %%% %%%%% %%% % % %%%%% %%%%% % % %%% % %%% % % %%% % % % %%%%%%% %%%%% % %%% % %%%%%%%%% % % %
% % %   %   %       %   %   %   %   %             % %   % %   % % %   % %   %   % %   % % % %   %   %   %   % % %       %   % % %
% %%% %%%%%%% %%% %%%%% % %%%%% %%% % % % %%%%%%% % %%% % % %%% % % %%% %%%%% % % % %%%%% % % % % %%% %%%%% % % % %%%%% % %%% % %
% %     %   %   %     % %     % %   % % % %   % % %   % % % %   %   %   %     % %       % % % % %     % % % % % %   %   %     % %
% %%%%% % %%%%% %%%%% % %%%%%%% % %%% %%% % % % % %%% % % % % %%% %%% % % %%%%% %%%%%%% % % % % % %%%%% % % % % % % % %%%%%%%%% %
%       %       %     % %       %      *%   %   %   %     %     % %   %     %                 %         %   %   % % %           %
%%%%%%%%%%%%%%%%%%%%%%%%%%%%%%%%%%%%%%%%%%%%%%%%%%%%%%%%%%%%%%%%%%%%%%%%%%%%%%%%%%%%%%%%%%%%%%%%%%%%%%%%%%%%%%%%%%%%%%%%%%%%%%%%%