%%%%%%%%%%%
%    P    %
% %%%%% % %
% % %   % %
% % % %%%%%
%   %     %
%%% %%%%%%%
% %       %
% %%%%%%% %
%    *    %
%%%%%%%%%%%