%%%%%%%%%%%%%%%%%%%%%%%%%%%%%%%%%%%%%%%%%%%%%%%%%%%%%%%%%%%%%%%%%%%%%%%%%%%%%%%%%%%%%%%%%%%%%%%%%%%%%%%%%%%%%%%%%%%%%%%%%%%%%%%%%%%%%%%%%%%%%%%%%%%%%%%%%%%%%%%%%
%                             %                P              %                                                             % %         %                       %
% %%%%%%%%%%%%%%%%%%%%%%%%%%%%% % %%%%%%%%%%%%%%%%%%%%%%%%%%% % %%%%%%%%%%%%%%%%%%%%%%%%%%%%%%%%%%%%%%%%%%% %%%%%%%%%%%%% % % %%%%% %%%%%%%%%%%%% %%%%%%%%%%%%% %
% %                             % % %           %   %       % % %                                       % %   % % %   %   % %                       %           %
% % %%%%%%%%%%%%%%%%%%%%%%%%%%% % % %%%%%%%%%%% %%% %%%%% %%% % % %%%%%%%%%%%%%%%%%%%%%%%%%%%%%%%%%%%%%%% %%% % % % % %%%%% % %%%%%%%%%%%%%%%%%%%%%%%%%%%%%%%%% %
% % %                 %       % % % %       % %   %         % % % %                                     %     %     % %       %                               % %
% % % %%%%%%%%%%%%%%%%%%% % % % % % % %%%%% % %%% % %%%%%%% % % % % %%%%%%%%%%%%%%%%%%%%%%%%%%%%%%%%%%%%%%%%%%% %%% % %%%%% %%% %%%%%%%%%%%%%%%%%%% %%%%%%%%% % %
%   % %                 % % % % % % %     %     %       % % % % % % %     %                                   % %   % %   %   % %                           % % %
% % % % %%%%%%%%%%% % % % % % %%% % %%% %%%%%%% % %%% % % % % % % % % %%%%%%%%%%%%%%%%%%%%%%%%%%%%%%%%%%%%%%% %%%%% % % %%%%% % % %%%%%%%%%%%%%%%%%%%%%%%%% % % %
% % % % %         % % % % % % % % % %   %     % % % % % %   % % % % %                                     %   %     % % %   % % % %                       % % % %
%%% % % % %%%%%%% % % % % % % % % % % %%% % % % % % %%% %%%%% % % % % %%%%%%%%%%%%%%%%%%%%%%%%%%%%%%%%% % % %%%%%%%%% % % % % % % % % %%%%%%%%%%%%%%%%%%% % % % %
% % % % % %     % % % % % % % % % % % %   % % % %     % %   % % % % % %   %                           % % %     %         %   % % % % %                 % % % % %
% % % % % % %%% % % % % % % % % % % % %%% % % % % %%% % % %%% % % % % % %%%%%%%%%%%%%%%%%%%%%%%%%%% %%%%% % %%%%%%%%%%%%%%%%%%% % % % % % %%%%%%%%%%%%% % % % %%%
%   % % % % % % % % % % % % % % % % %     % % % % %   % %   % % % % % % %                           % % % %                   % % % % % % %           % % % % % %
% %%% % % % % % % % % % % % % % % % %%%%%%% % % % % % % % %%% % % % % % % %%%%%%%%%%%%%%%%% % %%%%%%% % % % % %%%%%%%%%%%%%%% % % % % % % % %%%%%%%%% % % % %%% %
% % % % % %   % % % % % % % %               % % % % % %     % % % % % % % %     %         % %         % % % % %       %     % % % % % % % % %       % % % % % % %
% % % % % %%%%% % % %%% % %%%%%%%%%%%%%%%%%%% % % % % %%%%% % % % % % % % % %%%%%%%%%%%%% % %%%%%%%%% % % %%% % %%%%%%%%%%% % % % % % % % % % %%%%% % %%% % % % %
% % % % %       % % % % % %         %         % % % %     % % % % % % % % %             % %       %   % % % % % %         % % % % % % % % % % %   % % % % % % % %
% % % % %%%%%%% % % % % % %%%%%%%%% %%%%%%%%%%% % %%%%%%% % % % % % % % % % %%%%%%%%%%% % %%%%%%% % %%% % % % % % %%%%%%% % % % % % % % % % % % % % % % % % % % %
% % % %         % % % % % %                     % %     % % % % % % % %   % %         % % %     % % %   % % % % % %       % % % % % % % % % % % % % % % % % % % %
% % % %%%%%%%%% % % % % % % %%%%%%%%%%%%%%%%%%%%% %%%%% % %%% % % % % % % % % %%%%%%% % % % %%% % % % % % % % % % % % %%% % % % % % % % % % % % %%% % % % % % % %
% % %           % % % % % % %         %               % %   % % % % % % % % %       % % % %   % % % % % % % % % % % % % % % % % % % % % % % % %     % % % % % % %
% % %%%%%%%%%%%%% % % % % % % %%% %%%%% %%%%%%%%%%% % % %%% % % % % % % % % % %%% % % % % %%%%% % % % % % % % % % % % % % % % % % % % % % % % %%%%%%% % % % % % %
% %       %       % % % % % % %   %     %           %     % % % % % % % % % %   % % % % %       % % % %   % % % % % % %   % % % % % % % % % %           % % % % %
% % %%%%% % %%% %%% % % % % %%%%% % %%% % %%%%%%%%%%%%%%% % %%% % % % % %%% %%%%% % % % % %%%%% %%% % %%%%% % % % % % %%%%% % % % % % % % % %%%%%%%%%%%%% % % % %
% %     % % %   %   % %   % %     %   % % %             % % % % % % % % % %       % % % %     % % % % % %     % % % %       % % % % % % % %             % % % % %
% % %%%%% % %%% % %%% % % % % %%% %%% % % % % %%%%%%%%% % % % % % % % % % %%%%%%% % % % % %%%%%%% % % % % %%% % % % %%%%%%%%% % % % % % % %%%%% %%%%%%%%% % % % %
% % % %   %   % % %     % % % % %     % % % % %       % % % % % % % % %           % % % % %       % % %     % % % %           % % % % % %                     % %
% % % %%% %%%%%%% % %%% % % % % %%%%%%% % % % % %%%%% % % % % % % % % %%%%%%%%%%%%% % % % % %%%%%%% % %%%%%%% % % %%%%%%%%%%%%% % % % % %%%%%%% %%%%%%%%%%%%%%% %
% % %   %       % % %   % % % %         % % % % %   % % % % %   % % %               % %     %       % %   %   % %             % % % % %   %     %               %
% % % %%% %%%%%%%%% %%%%% % % %%%%%%%%%%% % % % % %%% % % %%% % % % %%%%%%%%%%%%%%%%% % % % % %%%%%%% % %%%%% % %%%%%%%%%%%%% % % % % %%%%%%%%%%%%%%%%%%%%%%%%% %
% %   %   %         %     % %           % % % % %     % %     % % %                   % % % % %       %       %           % % % % % %                         % %
% % %%% % % %%%%%%% % %%% % %%%%%%%%%%% % % %%% %%%%%%% % %%% % % %%%%%%%%%%%%%%%%%%%%% % % % % %%%%%%% %%%%%%% %%%%%%%%%%% % % % % %%% %%%%%%%%%%%%%%%%%%%%% % %
% % %   % % %     % % %   %           % % % % %         %   % %     %                   % % % % %                           % % % % %                       % % %
% % %%%%% % % %%%%%%%%%%%%%%%%%%%%%%% % % % % %%%%%%%%%%% %%% %%%%%%%%%%%%%%%%%%%%%%%%%%% %%%%%%%%%%%%%%%%%%%%%%%%%%%%%%%%%%% % % % % %%%%%%%%%%%%%%%%%%% %%% % %
% % %     % % %     %               % % % %                 %                               %                                 % % % %     %               % % % %
% % % %%%%% % % %%%%%%%%%%%%%%%%%%% % % % % %%%%%%%%%%%%%%%%%%%%%%%%%%%%%%%%%%%%% %%%%%%%%%%%%%%%%%%%%%%%%%%%%%%%%%%%%%%%%% % % % % %%%%%%%%%%%%%%%%%%%%%%% % % %
% % %     % % % %                 % % % % % %                                                                             % %   % %                       % % % %
% % %%%%%%% % % % %%%%%%%%%%%%%%% % % % % % % %%%%%%%%%%%%%%%%%%%%%%%%%%%%%%%%%%%%%%% %%%%%%%%%%%%%%%%%%%%%%%%%%%%%%%%%%% % % % % % %%%%%%%%%%%%%%%%%%%%% % % % %
% % %       % % % %             % % % % % % % %                                     %                     %             % % % % % %                     % % % % %
% % % %%%%% % % % % %%%%% %%%%% % % % % % % % % %%%%%%%%%%%%%%%%%%%%%%%%%%%%%%%%%%% % %%%%%%%%%%%%%%%%%%%%%%%%%%%%%%%%% % % % % % % %%%%%%%%%%%%%%%%%%%%% % % % %
% % % %     % % % % %         % % % % % % % % % %                       %           %                                 % % % % % % %                     % % % % %
% % % % %%%%% % % % % %%%%%%% % % % % % % % % % % % %%%%%%%%%%%%%%%%%%%%%%%%%%%%%%% % %%%%%%%%%%%%%%%%%%%%%%%%%%%%%%% % % % % % % %%%%%%%%%%%%%%%%%%%%% % % % % %
% % % % %     % % % % %     % % % % % % % % % % % % %                             % %                               % % % % % % %                     % % % % % %
% % % % % %%%%% % % % % %%% % % % % % % % % % % % % % %%%%%%%%%%%%%%%%%%%%%%%%%%% % % % %%%%%%%%%%%%%%%%%%%%%%%%%%%%% % % % % % %%%%%%%%%%%%%%%%%%%%% % % % % % %
% % % % % %     % % % %   % % % % % % % % % % % % % % %                         % % % % %                         % % % % % % %                     % % % % % % %
% % % % % % %%%%% % % % % % % % % % % % % % % % % % % % %%%%%%%%%%%%%%%%%%%%%%% % % % % % %%%%%%%%%%%%%%%%%%%%%%% % % % % % %%% %%%%%%%%%%%%%%%%%%% % % % % % % %
% % % % % % %   % % % % % % % % % % % % % % % % % % % % %                     % % % % % % %                     % % % % % % % %               %   % % % % % % % %
% % % % % % % %%% % % %%% % %%% % % % % % % % % % % % % % %%%%%%%%%%%%%%%%%%% % % % % % % % %%%%%%%%%%%%%%%%%%% % % % % % % % %%%%%%%%%%%%%%%%%%% % % % % % % % %
% % % % % % % %   % %     % % % % % % % % % % % % % % % % %                 % % % % % % % % %                 % % % % % % % %                   % % % % % % % % %
% % % % % % % % %%%%%%%%%%% % % %%% % % % % % % % % % % % % %%%%%%%%%%%%%%% % %%% % % % % % % %%%%%%%%%%%%%%%%% % % % % % % % %%%%%%%%%%%%%%% % % % % % % % % % %
% % % % % % % % %             %   % % % % % % % % % % % % % %               % % % % % % % % % %               % % % % % % % % % %             %   % % % % % % % %
% % % % % % % % % %%%%%%%%%%%%%%% % % % % % % % % % % % % % % %%%%%%%%%%%%% % % % % % % % % % % %%%%%%%%%%%%% % % % % % % % % % %%%%%%%%%%%%% % % % % % % % % % %
% % % % % %   % %       %       % % % % % % % % % % % % % % % %             % % % % % % % % % % %           % % % % % % % % % %               % % % % % % % % % %
% % %%% % % % % % %%%%%%% %%% % % % % % % % %%% % % % % % % % % %%%%%%%%%%% % % % % % % % % % %%% %%%%%%%%% % % % % % % % % % %%%%%%%%%%%%%%% %%% % % % % % % % %
% % % % % % % % % %     % % % % % % % % % % %   % % % % % % % % %         % % % % % % % % % % % % %         % % % % % % % % %               % % % % % % % % % % %
% % % % % % % % % % %%%%% % % % % % % % %%%%% % % % % % % % % % % %%%%%%% % % % % % % % % % % % % % %%%%%%% % % % % % % % % % % %%%%%%%%%%% % % % % % % % % % % %
% % % % % % % % % % %     % % % % % % % %     % % % % % % % % % % %     % % % % % % % % % % % % % % %       % % % % % % % % % % %         % % % % % % % % % % % %
% % % % % % % % % % % %%% % % % % % % % %%%%%%%%%%% % % % % % % % % % %%% % % % % % % % % % % % % % % %%% %%% % % % % % % % % % % %%%%%%% % % % % % % % % % % % %
% % % % % % % % % % %   % % % %   % % % %           % % % % % % % % %     % % % % % % % % % % % % % % % %     % % % % % % % % % % %       % % % % % % % % % % % %
% % % % % % % % % % % % %%% %%%%% % % % %%%%%%% %%%%% % % % % % % % %%%%%%% % % % % % % % % % % % % % % %%%%%%% % % % % % % % % % % % % % % % % % % % % % % % % %
% % % % % % % % % % % %         % % % %               % % % % % % %           % % % % % % % % % % % % %         % % % % % % % % % % % % % % % % % % % % % % % % %
% % % % % % % % % % % %%%%%%%%% % % % %%%%%%%%%%%%%%% % % % % % % %%%%%%%%%%%%% % % % % % % % % % % % %%%%%%%%%%% % % % % % % % % % % % %%% %%% % % % % % % % % %
% % % % % % % % % % %         % % % %               % % % % % % %               % % % % % % % % % % %               % % % % % % % % % %       % % % % % % % % % %
% % % % % % % % % % % %%%%%%% % %%% %%%%%%%%%%%%%%% % % % % % % %%%%%%%%%%%%%%%%% % % % % % % % % % %%%%%%%%%%%%%%%%% % % % % % % % % %%%%%%%%% % % % % % % % % %
% %   % % % % % % % % %     % % % %                 % % % % % % %                 % % % % % % % % %                   % % % % % % % %           % % % % % % % % %
% % % % % % % % % % % %%% % % % % %%%%%%%%%%%%%%%%% % % % % % %%%%%%%%%%%%%%%%%%%%% % % % % % % % %%%%%%%%%%%%%%%%%%%%% % % % % % % %%%%%%%%%%% % % % % % % % % %
% % % % % % % % % % %   % % % % % %               % % % % % %                       % % %     % %             %           % % % % %           % % % % % % % % % %
% % % % % % % % % % % %%% % % % % %%%%%%%%%%%%%%% % % % % % % %%%%%%%%%%%%%%%%%%%%%%% %%%%%%%%% %%%%%%%%%%%%%%%%%%%%%%%%%%% %%%%% %%%%%%%%%%%%% % % % % % % % % %
% % % % % % % % % %       % % % % % %           % % % % % % %                                                                   %       % %   % % % % % % % % % %
% % % % % % % % % %%%%% %%% % % % % %%%%%%%%%%% % % % % % % %%%%%%%%%%%%%%%%%%%%%%%%%%%%%%%%%%%%%%%%%%%%%%%%%%%%%%%%%%%%%%%%%%% % % % % % % % % % % % % % % % % %
% % % % % % % %       % %   % % % %           % % % % % % %                       %             %                             % % % % %     % % % % % % % % % % %
% % % % % % % %%%%%%%%%%% %%% % % % % %%%%%%% % % % % % % %%%%%%%%%%%%%%%%%%%%%%% % %%%%%%%%%%%%% %%%%%%%%%%%%%%%%%%%%%%%%%%% % % % % %%%%%%% % % % % % % % % % %
% % % % % % % %           %   % % % % %     %   % % % % %             %         % % %             %                         % % % % %       % % % % % % % % % % %
% % % % % % %%%%%%%%%%%%% % %%% % % %%%%%%% % % % % % % % %%%%%%%%%%%%%%%%%%%%% % % % %%%%%%%%%%%%% %%%%%%%%%%%%%%%%%%%%%%% % % % % %%%%%%%%%%% % % % % % % % % %
% % % %                   % %   % %     % % % % % % % %                         % % % %           %                       % % % % %   %         %   % % % % % % %
% % % %%%%%%%%%%%%%%%%%%%%% %%%%% %%%%% % % % % % % % %%%%%%%%%%%%%%%%%%%%%%%%% % % % % %%%%%%%%%%% % %%%%%%%%%%%%%%%%%%% % % % % %%%%%%%%%%%%% % %%% % % % % % %
% % %                       % %           % % % % % %                         % % % % % %         % % % %               % % % % %           % % % % % % % % % % %
% % %%%%%%%%%%%%%%%%%%%%%%%%% %%%%%%%%%%% % % % % % %%%%%%%%%%%%%%%%% %%%%%%% % % % % % % %%%%% % % % % %%%%%%%%%%%%%%% % % % % % %%% % %%%%% % % % % % % % % % %
% %                                     % % % % % % % %             % %     % % % % % % % %   % % % % %               % % % % % %   % % % %   % % % % % % % % % %
% % %%%%%%%%%%%%% %%%%%%%%%%%%%%%%%%%%% % % % % % % % % %%%%% %%%%% %%% %%% % %%% % % % % % % % % % % % %%%%%%%%%%%%% % % % % % % % % %%% % %%%%% % % % % % % % %
% % %           % %                   % % % % %   % % % %   %     %     %     % % % % % % % % % % % % %             % % % % % % % % %     %   % % % % % % % % % %
% % % %%%%%%%%% % % %%%%%%%%%%%%%%%%% % % % % % % % % % % %%%%%%%%%%%%% % %%%%% % % % % % %%% % % % % % %%%%%%%%%%% %%% % %%% % % %%% %%%%% %%% % % % % % % % % %
% % % %       % % % %               % % % % % % % % % % %     % %       % %   % % % % % %     % % % % %           % % % % % % % % %         %   % %   % % % % % %
% % % % % % % % % % % %%%%%%%%%%%%% % % % % % % % % % % % %%%%% %%%%%%%%% % %%% % % % % %%%%%%% % % % % %%%%%%%%% % % % % % % % % %%%%%%%%%%% % % % % % % % % % %
% % % % % % % % % % % %     %     % % % % % % % % % % % %   %         %   %   % % % % %         % % % % %     % % % % %     % % %             % % % % % % % % % %
% % % % %%% % % % % % % %%%%%%%%% % % % % % % %%% % % % % % % %%%%%%%%%%% % % % % % % %%%%%%%%%%% % % % % %%% % % % % %%%%%%%%%%%%%%%%%%%%%%%%% % % % % % % % % %
% % % % %   % % % % % % %       % % % % % % % % % % % % % % %           % % % % % % %             % % % % % %   % % %                         % % % % % % % % % %
% % % % %%%%%%% % % % % % % % % % % % % % % % % % % % % % %%% %%%%%%% % % % %%% % % %%%%%%%%%%%%% % % % % % % % % %%%%%%%%%%%%%%%%%%%%% % % % % % % % % % % % % %
% % % %       % % % % % % % % % % % % % % % % % % % % % %   % %     % % %     % % %             % % % %     % % % %                   % % % % % % % % % % % % % %
% % % %%%%% %%%%% % % % % % % %%% % % % % % % % % % % % %%% % %%%%% % % % %%% % % %%%%%%%%%%%%% % % % %%%%%%% % % % %%%%%%%%%%%%%%%%% % % % % % % % % % % % % % %
% % %     %     % % % % % % %     % % % % % % % % % % % % % % %   % % % % %   % %             % % % %         % % % %               % % % % % % % % % % % % % % %
% % % %%%%% %%%%% % % % % % % %%%%% % % % % % % % % % % % % % % %%% %%%%% % %%% %%%%%%%%%%%%% % % % %%%%%%%%%%% % % % %%%%%%%%%%%%% % % % % % % % % % % % % % % %
% %   %     %     % % % % % %       % % % % % % % % % % % % %           % %   %               % % %       %     % % % %           % % % % % % % % % % % % % % % %
% % % % % % %%%%% % % % % % %%%%%%%%% % % % % % % % % % % % %%%%% %%%%% %%%%% % %%%%%%%%%%%%%%% % %%%%%%%%%%%%%%% % % % %%%%%%%%%%% % % %%% % % % % % % % % % % %
% % %   % % % % % % % % % %           % % % % %   % % % %         % % %       % %     %       % %                 % % % %         % % % % % % % % % % % % % % % %
% % % %%% % % % % % % % %%%%%%% %%%%%%% % % % %%% % % % %%%%%%% %%% % %%%%%%% % % %%%%%%%%%%% % %%%%%%%%%%%%%%%%% % % % % %%% %%% % % % % % % % % % % % % % % % %
% % % %   % % %   % % % %               % % % % % % %         % %             % % %                             % % % %   % % % % % %   % % % % % % % % % % % % %
% % % % %%% % % % % % % %%%%%%%%%%%%%%%%% % % % % % % % % %%% % % %%%%%%%%%%%%% % % %%%%%%%%%%%%%%%%%%%%%%% %%%%% % % % % % % % % % % % % % % % % % % % % % % % %
% % % % %   % % % % % %                   % % % % % % % %   % % % %           % % % %     %                         % % % % % %     % % % % % % % % % % %   % % %
% % % % % % % % % % % %%%%%%%%%%%%%%%%%%%%% % % % % % %%% % %%% % % %%%%%%%%%%% % % % %%%%%%%%%%%%%%%%%%%%%%%%%%%%%%%%% %%% % % %%%%% % % % % % % % % % % % % % %
% % % % % % % % % % %                       % % % % % %   % % % % % %     %     % % % %                                   % % % %     % % % % % % % % % % % % % %
% % %%%%%%%%% % % % %%%%%%%%%%%%%%%%%%%%%%%%% % % % %%% % %%% % % % % %%%%%%%%%%% % % % %%%%%%%%%%%%%%%%%%%%%%%%%%%%%%%%%%% % %%% %%%%% % % % % % % % %%%%%%%%% %
% % %         % % %                             % % % % % %   % % % % %           % % % %                                             % % % % % % % % %         %
% % % %%%%% % % % %%%%%%%%%%%%%%%%%%%%%%%%%%%%%%% % % % %%% % % % % % % %%%%%%%%% % % % % %%%%%%%%%%%%%%%%%%%%%%%%%%%%%%%%%%%%%%% %%%%% % % % % % % % % %%%%%%% %
% % %     % % % %                         %       % % %     % % % % % % %         % % % % %                                     % %     % % % % % % %   %     % %
% % % %%% % % % %%%%%%%%%%%%%%%%%%%%%%%%%%%%%%%%%%% % %%%%%%% % % % % % % %%%%%%%%% % % % % %%%%%%%%%%%%%%%%%%%%%%%%%%%%%%%%%%% % % %%%%% %%% % % % % % %%% %%% %
% % %   % % % %                                   % %     %   % % % % % % %         % % % % %                                 % % % %     % % % % % % % % %     %
% % %%%%% % % %%%%%%%%%%%%%%%%%%%%%%%%%%%%%%%%%%%%%%%%%%% %%% % % % % % % % %%%%%%% % % % % % %%%%%%%%%%%%%%%%%%%%%%%%%%%%%%% % % % % %%%%% % % % % % % % %%%%% %
% %       % %                     %           %               % % % % % % % %       % % % % % %                             % % % % % %     % % % % % % %       %
% %%%%%%% % % %%%%%%% %%%%%%%%%%%%%%%%%%%%%%% % %%%%% %%%%%%%%%%%%% % % % % % %%%%%%% % % % %%% %%%%%%%%% %%%%%%%%%%%%%%%%% % % % % % % %%%%% % % % % % %%%%%%%%%
% %       % % %   % % %                     % % %     %             % % % % % %     % % % % % % %                         % % % % % % % %     % % % % %         %
% % %%%%%%% % % % % % % %%%%%%%%%%%%%%%%% % % % % %%% % %%%%%%%%%%%%% % %%% % % %%%%% % % % % % % %%%%%%%%%%%%%%%%%%%%%%% % % % % % % % % %%%%% % % % %%%%%%%%% %
% % %       % % % % % %                 % % % % % % % % %             % % % % % %       % % % % % %                     % % % % % % % % %       % % %         % %
% % % %%%%%%% % % % %%% %%%%%%%%%%%%%%% % % % % % % % % % %%%%%%%%%%%%% % % % % % %%%%%%% % % % % % %%%%%%%%%%%%%%%%%%% % % % % % % % % % %%% %%% % %%%%%%%%%%% %
% % % %       % %   % % %             % % % % % % % % % % % %           % % % % % %   %   % % % % % %                 % % % % % % % % % % % % % % %           % %
% % % % %%%%%%% % % % % % %%%%%%%%%%% % % % % % % % % % % % % %%%%%%%%%%% % % % % % % %%%%% % % % % % %%%%%%%%%%%%%%% % % % % % % % % % % % % % % %%%%%%%%%%%%% %
% % % % %   %   % % % % % %         % % % % % % % % % % % % % %           % % % % % % %     % % % % % %             % % % % % % % % % % % % % % %     %       % %
% % % % %%% % % % % % % % % %%%%%%% % % % % % % % % % % % % % % %%%%%%%%%%% % % % % % % %%%%% % % % % % %%%%%%%%%%% % % % % % % % % % % % % % % % %%%%%%%%%%% % %
% % % % % % % % % % % % % % %     % % % % % % % % % % % % % %   %   %       % % % % % % %     % % % % % %         % % % % % % % % % % % % % % % %             % %
% % % % % % % % % % % % % % % %%% % % % % % % % % % % % % % %%% % %%%%%%%%% % % % % % % % %%% %%% % % % % %%%%%%% % % % % % % % % % % % % % % % % %%%%%%%%% % % %
% % % % % % % % % % % % % % %   % % % % % % % % % % % % % % % % % %         % % % % % % % %   % % % %       %   % % % % % % % % % % % % % % % % %         % % % %
% % % % % % % %%% % % % % % % % %%% % % % % % % % % % % % % % % % % %%%%%%%%%%% % % % % % % %%% % % %%%%%%% % % % % % % % % % % % % % % % % % % % %%%%%%%%%%% % %
% % % % % % % % % % % % % % % % % % % % % %   % % % % % % %   %   % %       % % % % % % % %   % % %         % %   % % % % % % % % % % % % % % % %           % % %
% % % % % % % % % % % % % % %%% % % % % % % % % % % %%% % % % % %%% % %%%%%%% % % % % % % % %%% % %%%%%%%%%%% % % % % % % % % % % % % % % % % % %%%%%%%%%%%%% % %
% % % % % % % % % % % % % %     % % % % % % % % %   % % % % % %     % %       % % % % % % % % % %             % % % % % % % % % % % %   % % %               % % %
% % % % % % % % % % % % % %%%%%%% % % % % % % % % % % % % % % % %%%%% % %%%%%%% % % % % % %%% % %%%%% %%%%%%%%% % % % % % % % % % % % % % % %%%%%%%%%%%%%%% % % %
% % % % % % % % % % % % %         % % % % % % % % % % % % % % % %     % %     % % % % % % % %                 % % % % % % % % % % % % % % %           % %   % % %
% % % % % % % % %%% % % %%%%%%%%%%% % % % % % % % % % % % % %%% % %%% % % %%%%% % % % % % % % %%% %%%%%%%%%%%%% % % % % % % % % % % % % % %%%%% % %%%%% % %%% % %
% % % % % % % % % % % %             % % % % % % % % % % % % % % % %   % % %     % % % % % % %   %             % % % % % % % % % % % % % %     % % %     %   % % %
% % % % % % % % % % % %%%%%%%%%%%%% % % % % % % % %%% % % % % %%% % %%% % % %%%%% % % % % % %%% %%%%%%%%%%%%%%% % % % % % % % % % % % % % %%% %%% % %%%%% % % % %
% % % % % % % % % % %               % % % % % % % % % % % %   % % % %   % % %   % % % %           %             % % % % % % % % % % % % % % % %           % % % %
% % % % % % % % % % %%%%%%%%%%%%%%%%% %%% % % % % % % % % % % % % % % %%% % % %%% %%% %%%%%%%%%%%%%%%%%%%%%%%%%%% % % % % % % % % % % % % % %%%%%%%%%%%%% % % % %
% % % % % % % %                       % % % % % %     % % % % % % % % %   % % %   % %                             % % % % % % % % % % % % %               % % % %
% % % % % % % %%%%%%%%%%%%%%%%%%%%%%%%% % % % % % % %%% % % % % % % % % %%% % % %%% %%%%%%%%%%%%%%%%%%%%%%%%%%%%%%% % % % % % % % % % % % % %%%%%%%%% %%% % % % %
% % % % % % %                           % % %   % % % % % % % % % % % % %   % % %                                   % % % % % % % % % % % % %   %   %   % % % % %
% % % % % % % %%% %%%%%%%%%%%%%%%%%%%%%%% % % %%% %%% % % % % % % % % % % % % %%%%%%%%%%%%%%%%%%%%%%%%% %%%%%%%%%%%%% % % % % % % % % % % % % %%%%% %%% % %%% % %
% % % % % % %   % %                   %   % % %       % % % %   % % % % % % %                                   %     % % % % %   % % % % % % % %       % % % % %
% % % % % % %%%%% %%%%%%% %%%%%%%%%%%%%%%%% % % %%%%% % % % % % % % % % % % %%%%%%%%%%%%%%%%%%%%%%%%%%%%%%%%%%%%%%%%%%% % % % % % % % % % % % % %%%%%%%%% % % % %
% % % % % %   %                             % % % %   % % % % % % % % % % % % %                             %           % % % % % % % % % % % %           % % % %
% % % % % % % %%%%%%%%%%%%%%%%%%%%%%%%%%%%%%% % % % % % % % %%% % % % % % % % %%%%%%%%%%%%%%%%%%%%%%%%%%%%% %%%%%%%%%%%%% % % % % % % % % % % %%%%%%%%%%% % % % %
% % % % % % %                       %         % % % % % % % % % % % % % % % %                                             % % % % % % % % % %               % % %
% % % % % % %%%%%%%%%%%%%%%%%%%%%%% % %%% %%% % % % %%% % % % % % % % % % % %%%%%%%%%%%%%%%%%%%%%%%%%%%%%%%%%%%%%%%%%%%%%%% % % % % % % % % %%%%%%%%%%%%%%%%% % %
% % % % % %                     % % %   % %   %   % % % %   % % % % % % % %                                                 % % % % % % % %                 % % %
% % % % % %%%%%%%%%%%%%%%%%%%%%%% % % %%% %%%%% %%%%% % % % % % % % % % % %%%%%%%%%%%%%%%%%%%%%%%%%%%%%%%%%%%%%%%%%%%%%%%%%%% % % % % % % %%%%%%%%%%%%%%%%% %%% %
% % % % %                       % % %   % %       %   % % % % % % % % % %                                                     % % % % % % % %             % % % %
% % % % %%%%%%%%%%%%%%%%%%%%%%% % % %%% % %%%%%%% %%% % % % % % % % % % %%%%%%%%%%%%%%%%%%%%%%%%%%%%%%%%%%%%%%%%%%%%%%%%%%%%%%% % % % % % % % %%%%%%%%%%% % % % %
% % % % %                     % %       % %     %       % % % % % % % %                                                         % % % % % % % %         % % % % %
% % % % % %%%%%%%%%%%%%%%%%%% % %%%%%%%%% % %%% % %%% % % % % % % % % %%%%%%%%%%%%%%%%%%%%%%%%%%%%%%%%%%%%%%%%%%%%%%%%%%%%%%%%%%% % % % % % % % %%%%%%% % % % % %
% % % % %                 % %             % %   % % % % % % % % % %                                                         %     % % %   % % % %     % % % % % %
% % % % % %%%%%%%%%%%%%%% % %%%%%%%%%%%%% % %%%%% % % % % % % % % %%%%%%%%%%%%%%%%%%%%%%%%%%%%%%%%%%%%%%% %%%%%%%%%%%%%%%%%%%%%%%%% % % % % % % % %%% % % % % % %
% % % % % %         %   %               % %         % % % % % % %                                 %                   %             % % % % % % % %   % % % % % %
% % % % % %%% %%%%% % %%%%%%%%%%%%%%%%%%% % %%%%%%% % % % % % % %%%%%%%%%%%%%%%%%%%%%%%%%%%%%%%%%%%%%%%%%%%%%%% %%%%%%%%%%%%%%%%%%%%% % % % % % % %%%%% % % % % %
% % % % % %       %                       %       % % % % % %           %                                                       %     % % % % % %       % % % % %
% % % %%%%%%%%%%%%%%%%%%%%%%%%%%%%%%%%%%%%%%%%%%%%%%%%% % % %%%%%%%%%%%%%%%%%%%%%%%%%%%%%%%%%%%%%%%%%%%%%%%%%%%%%%%%%%%%%%%%% %%%%%%%%% % % % % %%%%%%%%% % % % %
% % %                                                   % %                                                         %                   % % % %             % % %
% % %%%%%%%%%%%%%%%%%%%%%%%%%%%%%%%%%%%%%%%%%%%%%%%%%%%%% %%%%%%%%%%%%%%%%%%%%%%%%%%%%%%%%%%%%%%%%%%%%%%%%%%%%%%%%%%%%%%%%%%%%%%%%%%%%%%% % % %%%%%%%%%%%%%%% % %
% % %                                                                                                                                     %                   % %
% %%%%%%%%%%%%%%%%%%%%%%%%%%%%%%%%%%%%%%%%%%%%%%%%%%%%%%%%%%%%%%%%%%%%%%%%%%%%%%%%%%%%%%%%%%%%%%%%%%%%%%%%%%%%%%%%%%%%%%%%%%%%%%%%%%%%%%%%%%%%%%%%%%%%%%%%%%%%% %
%                                                                         %                                                 *                                   %
%%%%%%%%%%%%%%%%%%%%%%%%%%%%%%%%%%%%%%%%%%%%%%%%%%%%%%%%%%%%%%%%%%%%%%%%%%%%%%%%%%%%%%%%%%%%%%%%%%%%%%%%%%%%%%%%%%%%%%%%%%%%%%%%%%%%%%%%%%%%%%%%%%%%%%%%%%%%%%%%%