%%%%%%%%%%%%%%%%%%%%%%%%%%%%%%%%%%%%%%%%%%%%%%%%%%%%%%%%%%%%%%%%%%%%%%%%%%%%%%%%%%%%%%%%%%%%%%%%%%%%%
%                 %       % %         %         %  P%   %         %   %   %     %               %   %
%%%%% %%%%%%%%%%% % % %%% % % %%%%% % %%%%% %%% % % % % % % %%%%%%% % % % % % %%% %%% % %%%%%%% % % %
%     %     %     % %   %   % %   % %       %   % % % %   % %       %   %   %     % % % %     % % % %
% % %%% %%% %%%%%%% %%% % %%% % %%% %%%%%%%%% %%% % %%%%%%% % %%%%%%%%%%%%%%%%% %%% % %%% %%% % % % %
% % %   % %           % % %     %   %       % %   %         %   %             % %   % %     % %   % %
% %%% %%% %%%%%%%%%%%%% % % %%%%% %%% %%%%% % % % %%%%%%% %%% %%% %%%%%%%%%%% % %%% % % %%%%% %%%%%%%
% %   %     %     %     % % % %   %   %   % % % %   %   % %   %   %   %     % %     % % %   %   %   %
% % %%%%% % %%%%% % %%%%%%% % % %%% %%%%% % % %%%%% % % %%% %%% %%% % % %%% % %%%%% % % % % %%% % % %
% %     % %     % %         % % % %   %   % %     %   %       % %   % %   %   %     %   % %   %   % %
% %%%%% % %%%%% % %%%%%%%%%%% % % %%% % % % %%%%% %%%%%%%%%%%%% % % %%%%% %%%%%%%%%%%%%%% %%% %%%%% %
%     % %   % %     %         % %     % % %     %   %       %   % %     %     %   %       % %       %
% %%% % %%% % %%%%% %%%%%%% % % %%%%% % % %%% % %%% % %%%%% % %%% %%% %%%%%%% % % % %%%%%%% %%%%%%% %
% %   %     %     % %       % %     %   %   % %   %   %   %   % % % %       %   %   % %       %     %
% % % %%%%%%% %%%%% % %%%%%%%%%%% % %%%%%%%%% %%% %%%%%%% %%%%% % % %%% %%%%%%%%%%%%% % % %%% % %%%%%
% % % % %   %         %         % %       %   % %             %   %   %   %         %   % %   %     %
% % % % % % % %%%%%%%%% %%%%%%% % %%%%%%% % %%% %%%%%%%%%%% %%% %%% % %%% % %%%%% %%% %%% %%%%%%%%% %
% % %   % %   %         %       % %     % % %     %         %   %   % % %   %   % %   % %         % %
% % %%%%% %%%%% %%%%%%%%% %%%%%%% % %%%%% % %%% % % %%%%%%%%% %%% % % % %%%%% %%% % %%% %%%%%%% %%% %
% %       %   %         %   %   % %   %   %   % %   %       %   % % %   %       %   %   %     % %   %
% %%%%%%%%% %%%%%%%%%%% %%% % % % %%% % %%% % %%%%%%% %%%%% %%% %%% %%% % %%%%% %%%%% % % % % % % %%%
%     %   %           % % % % % %     % %   %     %   %   % %   %   % % %     %       % % % % % % % %
%%%%% % % % %%%%%%% %%% % % % % %%%%%%% % %%%%%%% % %%% % % % %%% %%% % %%%%% %%%%%%%%% % % %%% % % %
%   %   % % %     %   % %     %         %   %   %   %   % %   %   %     %   %   %     % % %   %   % %
% %%%%%%% % % %%% %%% % %%%%%%%%%%%%%%%%%%% % %%%%%%% %%%%%%%%% % %%%%% % % %%% %%%%% % % %%% %%%%% %
%       % %   %   %   %   % %       %   %   %     %         %   %     % % %   %     % %     %   %   %
% %%%%% % %%% %%%%% %%%%% % % % %%%%% % % %%%%%%% % %%%%%%% % %%%%% % % % % % %%%%% % %%%%%%% % % % %
% %   % % %   %     %     %   %       %     %   %       % %   %   % % % % % %     % %     %   %   % %
% %%% % % % %%% %%% % %%%%%%%%% %%%%%%%%%%% % % %%%%%%% % %%%%% % %%% %%% % %%%%%%% % % %%% %%%%%%% %
%     %   %   %   % %   %     % % %     %     %     % % %     % %   % %   %           % %   %     % %
%%%%% %%%%%%%%% % %%%%% % %%% % % % %%% %%%%%%%%%%% % % % %%%%% %%% % % %%%%%%%%%%%%%%% % %%% %%% %%%
%   % %       % %     %     % %   %   % %     %   % % % % %     % % %     %   %     %   %       %   %
% %%% % % %%% %%%%%%% %%%%%%% %%%%%%% % % %%% % % % % % % % %%%%% % %%%%%%% % % %%% % %%%%%%%%%%%%% %
%   % % % %   %         %   %         % %   % % % % %     % %               % % %   % %   %   %     %
% % % %%% % %%% %%%%%%%%% % % %%%%%%%%% %%% % %%% % %%%%%%% %%%%%%%%%%%%%%%%% % % %%% % % % % % %%% %
% % %     % %   %         % %     %   %   % %   %         % %       %       %   %   % % %   % % %   %
% % % %%%%% % % % %%%%%%%%% %%%%% % % %%% % %%% %%%%%%%%% % % %%%%% % %%% % %%%%%%% % % % %%%%% %%% %
% %   %   % % % % %       % %       % % %   % %   %   %   %       % % %   %   %   % %   % %   %   % %
% %%%%% % % %%% % %%%%% %%% %%%%%%%%% % %%%%% %%% % % % %%% %%%%% % % % %%%%% % % % %%%%% % % % % % %
% %     % %     %   %   %   %     %       %     % % %   %   %   % % % % %       % % %     % % % % % %
%%% %%%%% %%%%% %%% % %%% %%% %%% %%%%%%% %%% %%% % %%%%%%%%% % %%% % % %%%%% %%%%% % %%%%% % %%% %%%
%   % %   %   %   % %     %   %         %     %   %   %       % %   % % %   % %     % %     %   %   %
% %%% % %%% % % %%% % %%%%%%% %%%%%%%%% %%%%%%% %%%%% %%% %%%%% % %%% % % % % % %%%%% % %%%%%%% % % %
%   %   %   %   %   %       %     %       %     %   %   %     %   %   %   % % % %     %   %   % % % %
%%% % %%%%%%% %%% %%%%%%%%% % %%% %%%%%%% % %%%%% %%%%% % %%% %%%%%%%%%%%%% %%% %%%%% %%% % %%% %%% %
%   % %     %   % %       % %   %       %   %     %     %   %           %   %   %   % %   %         %
% %%% % %%% %%%%% % % %%% % % %%%%% %%% %%%%% % % % %%%%%%% %%%%%%%%%%% % %%% %%% % %%% % %%%%%%%%%%%
%   %   %         % % % % % % %   % %   %     % % %       %   %     %   %     %   %     % %   %     %
% % %%%%%%%%%%%%%%%%% % % % %%% % % % %%% %%%%% % %%%%%%% %%% % %%% % %%%%% %%% %%%%%%%%%%% % % %%% %
% %     %   %     %   %   % %   % % % %   % %   %   %     % % % %   %     % % %             %     % %
%%% %%% % % % %%% % %%%%% % % %%% %%% % %%% % %%%%%%% %%%%% % % % %%%%%%% % % % %%%%%%% %%%%%%%%%%% %
% %   %   % % % % %     % %   % %   % %   % %         %     %   % %     % % %   %     % %       %   %
% %%%%%%%%% % % % % %%% %%%%%%% %%% % %%% % %%%%%%%%%%%%%%% %%%%% % %%%%% % %%%%% %%% % % %%%%% % %%%
%           % % % % % %           %   % %     %     %       %     % %     %   %   % % %   %     %   %
%%%%%%%%%%%%% % % % % %%%%%%%%% %%%%%%% %%%%% %%%%% % % % %%% %%%%% % %%%%%%% % %%% % % %%%%% %%%%% %
%       %     %   % % %       %   %   %     %     %   % % %   %     % %       %   %   % %   %     % %
% %%%%% % % %%% %%% % % %%% % %%% % % % %%% %%%%% %%%%% %%% %%% %%% % %%%%% %%% % % %%% % % %%%%%%% %
%   %   % % % % %   %   %   % % %   % %   %     %     %         %   %     %   % % %   % % %   %     %
% % %%%%% % % % %%% %%%%% %%% % %%%%% %%% % %%%%%%%%% % %%%%%%%%%%%%% %%% %%% %%% %%% % % %%% % %%%%%
% % %     % % %   %       %   %     %   % %         % % %   %       %   %   %     % % % % %   %     %
% % % %%%%% % %%% %%%%%%%%% %%% %%% %%% % %%%%%%% % % % % % % %%%%% %%% %%% %%%%%%% % % % % %%% %%% %
% %   % %   %   % %     %       %   %   % %     % % % % % %   %     % %   % % %     % % % % % %   % %
% %%%%% % %%%%% % % %%% %%%%%%%%%%%%% % % % %%%%% %%% % % %%%%% %%%%% % %%% % % %%% % % % % % % %%% %
% %     %     % %   % % %             % % %     %     % %     % %       %   % %   %   % % % % % %   %
% %%%%% %%%%% % %%%%% % % %%%%%%%%%%% %%% % %%% %%%%%%% %%%%% % %%%%%%%%% %%% %%% %%%%%%% % % % % % %
%           % %     %   % %         % %   %   %       % %     %   %       %     %   %     % %   % % %
%%% %%%%%%%%% %%% %%% %%% % %%%%%%% %%% %%%%% % %%% %%% % %%%%%%% % %%%%%%% %%% %%% % %%%%% % %%% %%%
%   %   %   %   % %       %     % %     %     %   % %   % %         %       %   % % %   % % %   %   %
%%%%% % % % %%% % % %%%%%%%%%%% % %%%%%%% %%%%% % %%% %%% % %%%%%%%%% %%%%%%%%% % % %%% % % %%% %%% %
%     %   %     % %   %         %         %   % %     %   % %   %             %   % %   % % %     % %
% %%%%%%%%%%%%%%% %%% % %%%%%%%%%%% %%%%% % % %%%%% %%% %%% % % % %%%%%%%%%%% %%% % % %%% % % %%%%% %
% %             % %   % %         % %   % % %     %   %   % % % % %     %     % % % % % %   % % %   %
% % %%%%%%%%%%% % % %%% % %%%%% % %%% % % % %%%%% %%%%%%% %%% % % %%% % % %%%%% % % % % % %%% % % %%%
% % %     %   % %     % % %     %     % % %   % %     %   %   % %     % %     %   % % % %   %   %   %
% % % % % % %%% %%%%%%% %%% %%%%%%%%%%% % %%% % %%%%% % % % %%% %%%%%%% %%%%% %%%%% % % %%% %%%%%%% %
% % % % %   %   %     %   % %   % %   % %   % %         % %   %       % %   %       % %   %         %
% % %%% %%%%% % % %%% %%% % % % % % % % %%% % %%% %%%%%%%%%%% %%%%%%% %%% % % %%%%%%% % % %%%%%%%%% %
% %   % %   % % % % %     %   % %   %   %   %   %     %     % %     %     % %   %     % %     %   % %
% %%% % % % % % % % %%%%%%%%% % % %%%%%%%%%%%%% %%%%%%% % %%% %%% % %%%%%%% %%% % %%%%%%% % % %%% % %
% %   %   % % % % %         % % %     %       %       % %   %   % % %       %   %       % % %   % % %
% % %%%%% % % % % %%% %%%%% % % %%%%% %%% %%% %%%%%%% % %%% %%% % % % %%%%%%% %%%%% %%% % % %%% % % %
% %     % % % % %     %   % % % %   %   % % %     %   %   %   % % % % %     % %   % %   % %   %   % %
% %%%%% % % % % %%%%%%%%% % %%% % % %%% % % %%%%% % %%% %%% % % % % % % %%% % % % %%% %%% %%% %%%%% %
%   %   % % % % %         %     % %   %   %   %   %   % %   % % % % % %   % %   % %   % % % %     % %
% %%% %%%%% % %%% % % %%%%%%%%%%%%% % %%%%% % % %%% % % % %%%%% %%% % %%% % %%%%% % %%% % % %%%%% % %
%   % %     %     % % %           % % %     % % %   %   %       %   % %   %   %   %   %   %   %   % %
% % % % % %%%%%%%%% %%% % %%%%%%% % %%% % %%% % %%%%%%%%% %%%%%%% %%% % % %%%%% %%%%% % %%% % % %%% %
% % % % % %       %     %   %   %   %   % %   % %   %   %       %   % % % %   %       % %   % %     %
%%% % % % % %%% %%%%%%% %%% % %%% %%% %%% % %%% % % % % % %%%%% %%% % % %%% % %%%%%%%%% %%% % %%%%%%%
%   % % %   %   %     % %   %     %   %   %   %   %   % % %   %     % % %   %         %     %     % %
% % % %%%%%%% %%% %%% %%% %%% %%%%% %%% %%%%% %%%%%%%%% % % % %%%%%%% % % %%%%%%%%% %%%%%%%%%%%%% % %
% % %       %   % %     % %       %   % %   %   %     % % % % %     % %   %         %           % % %
% %%%%%%%%% %%% % %%%%% % % %%%%%%%%% % % % %%% %%%%% % %%% % % %%% % %%% % %%%%% %%% %%%%%%%%% % % %
%         %   % %   %     % %       % % % %           %     % % %   %   % %   % % %   %       %   % %
% %%%%% % %%% % %%% %%%%%%%%% %%% %%% % % %%%%%%%%%%% %%%%%%% % % %%%%% %%%%% % % % %%% %%%%% %%%%% %
% %   % %   % %   %   %     %   %     % % %   %       %     %   %       %     % % % %   % %   %     %
% %%% % %%%%% % % %%% % %%% %%% %%%%%%% % % % %%%%%%%%% %%% %%%%%%%%%%%%% %%%%% % % % %%% % %%%%%%% %
%     % %     % %   % %   %   %   % %   % % % %       % % %             %   %     % %   % % %   %   %
%%%%% % % %%%%% %%% % %%% %%% %%% % % %%%%% % % %%%%% % % %%%%%%% %%%%%%% % %%%%%%% %%% % % % % % % %
%     %         %   %       %       %       %      *%           %         %             %     %   % %
%%%%%%%%%%%%%%%%%%%%%%%%%%%%%%%%%%%%%%%%%%%%%%%%%%%%%%%%%%%%%%%%%%%%%%%%%%%%%%%%%%%%%%%%%%%%%%%%%%%%%