%%%%%%%%%%%%%%%%%%%%%%%%%%%%%%%%%%%%%%%%%%%%%%%%%%%%%%%%%%%%%%%%%%%%%%%%%%%%%%%%%%%%%%%%%%%%%%%%%%%%%
%     %   %   %         %   %     %     %     %         %       %               %   %   %     %P%   %
% % % % % % % % %%%%%%% % % % % % % %%% % %%% % %%%%% % % %%%%% % %%%%% %%% %%% % % % % % %%% % % % %
% % % % % % % % %       % % % % % %   %   %   % %   % %         % %   % %   %     % % %   %   % % % %
% % % % % % % % % %%%%%%% % % % % %%% %%%%% % % % % % %%% %%%%%%% % % % % %%% %%%%% % % %%% %%% % % %
%   % % % %   %             %   % %   %     %   % %     %       % % %   % %   %   %   %     %   % % %
%%%%% % % %%% %%% %%%%%%% %%%%%%% % %%% %%%%%%%%% %%% % %%%%%%% % % % %%% % %%% % %%%%%%%%%%% % % % %
%     %     %   % %       %     %   %   %     %     % % %     % %   % %   % %   %   %         % % % %
% %%%%%%%%% % % % % %%% %%% %%% %%%%% %%% %%% % %%% % % % %%% % %%% % % %%% % %%%%% % %%%%% %%% % % %
% %   %   %   % %     %       % %         %   % %     %   %   %     %   %   % %   %   %     %   % % %
% % % % % %%%%% %%% % % %%%%% % % %%% %%%%% %%% % % %%%%% % %%%%%%%%%%%%% %%% % % %%%%% %%%%% %%% % %
%   % % % %   %   % % % %   % % % %   %     %   % % %     % %   %   %     %   % %     % %       % % %
%%%%% % % % % %%% % % % % % % % % % %%% %%% % % % % % % %%% % % % % % %%%%% %%% %%%%% % % %%%%% % % %
%       % % %   % % % %   %   %   % %       % % % %   % %   % %   % % %   %   %       %   %   %   % %
% %%% %%% % %%% % % % %%%%%%%%%%%%% % % %%%%% % % % %%% % % % %%% % % % % %%% %%%%%%% %%% % % %%%%% %
%   %   %     %   % %           %   % % %   %   % %   % % % %   %   % % %     %           % %   %   %
%%% %%% %%%%% % %%% % %%%%%%%%% % %%% % % % %%%%% %%% % % % % % %%% % % %%%%% % %%%%%%%%%%% %%% % % %
%     %       %     %   %   %   % %   % % % %   %     % %   % %     % %   %   %               % % % %
% %%% %%%%% %%%%% %%%%% % % % % % % %%% % % % % %%%%%%% %%%%% %%%%%%% % % % %%% %%%%%%% %%%%% % % % %
% %       %     %     % % %   % %   %   %   % %       %     %     %   % %   %   %     %       % % % %
% % % %%% %%%%% %%%%% % % %%%%% %%%%% % %%% % %%%%%%% %%%%% %%%%% % %%% %%%%% %%% %%% %%%%%%%%% % % %
% % % %           %   % %       %     %   %         %             %   %       %   %           % % % %
% % % % % %%%%%%% % %%% %%% %%%%% % %%%%% %%%%%%%%% %%%%%%%%%%%%%%%%% %%%%%%% % %%% %%%%%%%%% % % % %
% % % % % %     %   %     % %   % % %   % %         %       %   %     %       %     %     %   %   % %
% % % % % % %%% %%%%% %%% % % % % % % % % % %%% %%%%% %%%%% % % % % %%% %%%%%%%%%%% % %%% % %%%%%%% %
% %   % % %   %           % % % %   % %   %   % %   %       % % % %   % %     %   % %       %     % %
% % %%% % %%% %%% %%%%%%% % % % % %%% %%%%%%% % % % % %%%%% % % % % % % % %%% % % % %%%%% %%% % % % %
% %     %     %   %       % % % %   % %       %   %   %   % % %   % % % %     % % %   %   %   % % % %
% %%%%%%% %%%%% %%% %%% %%% % % %%% % % %%%%%%%%%%%%%%% % % % %%% % % % % %%%%% % %%% % %%% %%% % % %
%       % %     %   %   %   % % %   % % %           %   % % %     %   % % %     % %   % %     %   % %
% %%%%% % % %%%%% %%% %%% % % % % % % % % % %%%%%%% % %%% % %%%%%%%%%%% % % %%% % % %%% % %%% %%% % %
%     %   % %   %     %   %     % % % %   % %     %   %   %   %   %     % %     % % %   %     %   % %
%%% % %%% % % % %%%%% % %%%%%%%%% % % %%%%% % %%% %%%%% % %%% % % % %%% % %%%%%%% % % %%%%%%% % %%% %
%   %     %   %     %   %         % %   %   %     %     % %   % % %     %   %     %   %     %     % %
% %%% %%%%%%%%%%%%% %%%%% %%%%%%%%% %%% % %%%%%%% % %%%%% % %%% % % %%%%%%% % %%%%%%% % %%% %%% % % %
%     %   %   %   %     % %       %   % %       %   %     % %   %   %       % %   %   % %     % % % %
%%%%%%% % % % % % %%%%% % % %%%%% %%% % % %%%%% %%% % % %%% % % %%%%% %%%%%%% % % % %%% % % % % % % %
%       % % % % %       %   %         % % %     %   % % %   % %       %     %   %   %   % % % %   % %
% %%%%% % % % % %%%%%%%%%%%%% %%% %%% % % % %%%%% %%% % % %%% %%%%%%%%% %%% % %%%%%%% %%% % % % %%% %
% %     % %   % %     %     % %   %   % % % %   %   %     %   %   %   %   % % %     %     %   %     %
% % % %%% %%% % % %%% % %%% % % %%% %%% % % % % %%% %%% %%% %%% % % % %%% % % % %%% %%%%%%% %%%%%%% %
% % %         % % %   % %   %   %   %     % % %   %   %   % %   % % %       % %     %     %         %
% % %%%%%%%%%%% % % %%% % % % %%% %%% % %%% % %%% %%% %%% % % % % % % %%%%%%% %%% %%% %%% %%%%%%%%%%%
%       %       % %     % % %   %     % %   %         %   % % %   %   %     %         %   %         %
%%%%%%% % %%%%%%% %%%%%%% % %%% % %%%%% % %%%%%%%%%%% % %%% % %%%%% %%% %%% % %%% %%%%% %%% %%%%%%% %
%   %   % %   %   %   %   %   % % %   % %     %       %   %       %     %   % %   %     %   %       %
% % % %%% % % % %%% % % %%%%% % % % % % %%%%% % %%%%%%%%% %%% %%% %%%%%%% %%% % %%% % %%% %%% % %%% %
% % %     % %   %   %   %   % % %   % % %   %   %     %     %           % %   %     %   %   % %     %
% % %%%%%%% %%%%% % % %%% % % % %%%%% % % % % %%% %%% % % % %%%%%%%%%%% % % % % %%%%%%% %%% % %%%%%%%
% %     %     %   % %     % % % %     % % % % %     %   % % %     %   % % % % % %         % %   %   %
% %%%%% % %%% % %%% %%%%%%% % % % %%%%% % % % % %%% %%% % % % %%% % % % % % % % % % %%%%% % %%% % % %
% %   % %     %     %   %   %     %     % %   %   %   %   % % %   % % % % %   %   %         %     % %
% % % % %%% %%%%%%% % % % %%%%%%%%% %%%%% %%%%% % %%% %%% % % % %%% % % % %%%%%%%%%%%%%%% %%% %%%%% %
% % % %   % %   %   % % %         %       %     % %     % % % % %     % % %     %       %   % %   % %
% % % % % % % % % %%% % % %%%%%%% %%% %%% % % %%% % %%% % % % % % % %%% % % %%% % % %%% %%% % % % % %
% % %   %   % % % %   %   %     %   %   %   % %   %     % %   % % % %     %       % %         % %   %
% % % %%%%%%% % % % % % %%% % % %%% %%% %%%%% % % %%%%%%% %%% % % % % %%%%%%%%%%%%% % %%%%%%%%% %%%%%
% % %         % %   % %     % %           %   % % %     %     %   %   %       %     % %       %     %
% % %%%%%%%%% % % %%% %%%%% % % %%%%%%%%% % %%% % % % % %%%%%%%%%%%%% % %%%%% % %%% % % %%%%% %%%%% %
% %   %   %   % %           % % %       %   %   % % % % %     %     % % %   %   %   % %     % %     %
% %%% % % % %%% %%%%% %%% %%% % % %%% % %%%%% %%% % % % % %%% % % % % % % % %%%%% %%% %%%%% % % %%%%%
%   % % %           %   % %   % %     %       %   %   % %     % % % % % % %       %     %   %       %
%%% % % %%% %%%%%%% %%% % % %%% %%%%%%%%%%%%% % % %%%%% %%% %%% % % % % % % %%%%%%% % % % % %%%%%%% %
%   % %   % %       %     %           %     % % %     %     %   % %   % %   %       % % % % %   %   %
% % % %%% % % %%%%%%% % %%%%%%%%% %%% % % % % % %%%%% %%% %%% % % % %%% % %%% %%%%%%% % % % % % % %%%
% % %     %   %     % % %       %     % % %   %     %   %     % % %       %   %         %   % % %   %
% % %%%%% % %%% %%% % % % %%%%% %%%%%%% % %%%%%%%%% % % % %%%%% % %%%%%%%%% %%% %%%%%%%%%%%%% % %%% %
% %       % %   %   % % %     %         % %   %   % % %   %       %         %         %     % %     %
% %%% %%%%% % %%% %%% % % %%% %%%%%%%%%%% % % % % % % % %%% %%% %%% % %%%%%%% %%%%%%% % %%% % %%%%% %
%   %       %         % % %               % %   %   %   %     % %   % %   %   %       % %   %     % %
%%% %%%%%%% %%%%%%%%% % % % %%%%% %%%%%%%%% %%%%%%%%%%%%% %%% % % % % % % % %%% % %%%%% % % % %%% % %
%     %   % %       %   % %       %           %       %     % %   % % % %   %   % %     % %   %   % %
% %%% % % % % %%% % %%%%% %%%%% %%% %%%%%%%%% % %%%%% % % % % %%%%% % % %%%%% % % % %%%%% %%%%% % % %
% %     % % % %   % %   % %     %     %   %   % %     % % % %   %   %   %     % %   %   %       %   %
% % % %%% % % % %%% % % % % % %%% %%% % % % %%% % % %%% % % % % % %%%%%%% %%%%% %%%%% % %%%%%%% %%%%%
% % %     % % % %   % % %   % %         % % %   % % %   % %   % %       % %     %   % %     %       %
% % %%%%%%% % % % %%% % %%%%% % % %%%%%%% % % % % % % %%% % %%% %%%%%%% % % %%%%% % % % %%% % %%%%% %
% %         % % %   %         % % %       % % % % % % %   %     %     % %   %     % % % %   % %     %
% %%%%%%%%%%% % %%% %%%%%%% %%% % % %%%%%%% % % % % % % % %%%%% % % % % %%%%% % %%% % % % % % % %%% %
% %           % %         % %     %   %     %   % % % % %       % % % %       % %   % % % % %       %
% % % %%%%% %%% % % %%%%% % % % %%%%% % %%%%%%%%% % % % %%% %%%%% % % % %%%%%%% % %%% % % % %%%%%%%%%
%   % %   % %   % %     % %   % %       %     %   % % %   % %     % %   %   %   % %   % % %     %   %
% %%% % % % % %%% %%%%% % %%%%% % %%%%%%% %%% % %%% % % % % % % %%% %%%%% % % %%% % % % % %%% % % % %
% %   % % %       %   % % %     %     %   %   % %   %   % % % %     %   % % %   % % % % %     % % % %
% % %%% % %%%%%%% % % % % % %%%%%%%%% % %%% % % % % % %%% % % %%%%%%% % % % %%% % % % % % %%%%% % % %
%   %   %       %   % % % % %     %   % %   % %   % % %   % % %       % % %     % %   % % %   % % % %
%%%%% %%% %%% % %%%%% % % % % %%% % %%% % %%% % %%% % % %%% % % %%%%%%% % %%%%% % %%% % % % % % % % %
%       %   % %       %   % % %     %   % %   %   % %   %     % %     % % %   % %   % % %   % %   % %
% %%% % %%% % % %%% %%%%%%% % % % %%% %%% % %%%%% % %%%%% %%%%% % %%% % % % % % %%% % % % %%% % %%% %
%   % %     % % %   %       % % % %   %   % %     %     % %   %       %     % %   % %     %   % %   %
% % % % %%%%% % % %%% % %%% % % % % % % % % % %%%%%%%%% % % % % %%%%%%%%% %%% %%% % %%%%%%% %%% % %%%
% % %   %   %   % %   % %   %   %   %   %   % %         %   % % %         %     % % %     %   % %   %
% % %%%%% % %%% % % %%% % %%% %%% %%%%%%%%%%% % %%% %%%%%%% % % % %%%%% %%% %%% % % % %%% %%% % %%% %
% %       %     % %   % % %   %   %         % % %   %   %   %   %     % %   %   % % %   %     %     %
% %%%%%%% %%%%%%% %%% % % % %%% %%% %%%%%%% % % % %%% % % %%%%%%%%%%% % % %%% %%% % %%% %%%%%%%%% %%%
% %     % %       %   %   % %   %   %     % % %   %   % % %           % % %   %   %     %       %   %
% % %%% % % %%%%%%% %%% %%% % % % %%% %%% % % %%%%% %%% % % %%%%%%%%%%% % % % % % % %%%%% %%% % %%% %
%   %   %   %     %   % %   % %     %     % % %   %     % % %   %   %   %   %   % % %     %   %     %
% %%% % %%%%% %%% %%% % % %%% %%%%% % %%%%% % % % %%% %%% % % % % % % % %%%%%%%%% % % % %%% %%%%%%% %
%     %                 %           %       %   %         %   %  *%   %           %   %             %
%%%%%%%%%%%%%%%%%%%%%%%%%%%%%%%%%%%%%%%%%%%%%%%%%%%%%%%%%%%%%%%%%%%%%%%%%%%%%%%%%%%%%%%%%%%%%%%%%%%%%