%%%%%%%%%%%%%%%%%%%%%%%%%%%%%%%%%%%%%%%%%%%%%%%%%
%                                               %
%                               %               %
%                               %               %
%                               %               %
%                               %               %
%                               %               %
%                               %               %
%                               %               %
%                               %               %
%                               %               %
%                               %               %
%                               %               %
%                               %               %
%                               %               %
%                               %               %
%               %%%%%%%%%%%%%%%%%               %
%                               %               %
%                               %               %
%                               %               %
%                               %               %
%                               %               %
%                               %               %
%                               %               %
%                               %               %
%                               %               %
%                               %               %
%                               %               %
%                               %               %
%                               %               %
%                               %               %
%                               %               %
%               %%%%%%%%%%%%%%%%%               %
%               %                               %
%               %                               %
%               %                               %
%               %                               %
%               %                               %
%               %                               %
%               %                               %
%               %                               %
%               %                               %
%               %                               %
%               %                               %
%               %                               %
%               %                               %
%               %                               %
%P              %*                              %
%%%%%%%%%%%%%%%%%%%%%%%%%%%%%%%%%%%%%%%%%%%%%%%%%