%%%%%%%%%%%%%%%%%%%%%%%%%%%%%%%%%%%%%%%%%%%%%%%%%%%%%%%%%%%%%%%%%%%%%%%%%%%%%%%%%
%            P                      %                                           %
% %%%%%%%%%%%%%%%%%%%%%%%%%%%%%%%%%%%%%%% %%%%%%%%%%% %%%%%%%%%%%%%%%%% %%%%%%%%%
% % %                                             %   %                         %
% % % %%%%%%%%%%%%%%%%%%%%%%%%%%%%%%%%%%%%%%%%%%%%%%%%%%%%%%%%%%%%%%%%%%%%%%%%%%%
% % % %                                                                         %
% % % % % %%%%%%%%%%%%%%%%%%%%%%%%%%%%%%%%%%%%%%%%%%% %%%%%%%%%%%%%%%%%%%%%%%%% %
% % % % % %                                                           %     % % %
% % % % %%% %%%%%%%%%%%%%%%%%%%%%%% % %%%%%%%%%%%%%%%%%%%%%%%%%%%%%%%%%%%%% % %%%
% % % % % %                       % % %                                 % % % % %
% % % % % %%% %%%%%%%%%%%%%%%%%%% % % % %%%%%%%%%%%%%%%%%%%%%%%%%%%%%%% % % % % %
% % % % % %                     % % % % %                             % % % % % %
% % % %%% %%%%% %%%%%%%%%%%%%%% % % % %%% %%%%%%%%%%%%% %%%%%%%%% %%% % % % % % %
% % % % %               %     % % % % % % %           %         % %   % % % % % %
% % % % %%%%%%%%%%%%%%%%%%%%% % % % % % % % %%%%%%%%% % % %%%%% % %%%%% % % % % %
% % % % %                     % % % % % % % %       % % % %   % % %     % % % % %
% % % % % %%%%%%%%%%%%%%%%%%% % % % % % % % % %%%%% % % % % %%% % % %%% % % % % %
% % % % %                   % % % % % %   % % %     % % % %     % % %   %   % % %
% % % % %%%%%%%%%%%%%%%%%%% % % % % % % % % % % %%% % % % %%%%%%%%% %%% % % % % %
% % % %                   % % % % % % % % % % % %   % % %         %   % % % % % %
% % % %%%%%%%%%%%%% %%%%% % % % % % % % % % % % %%%%% % %%%%% %%%%%%% % % % % % %
% % %                 %   % % % % % % % % % % %       % %   % %     % % % % % % %
% % %%%%%%%%%%%%%%%%%%%%% % % % % % % % %%%%% %%%%%%%%% % %%% % %%% % % % % % % %
%       %                 % % % % % % % %               %   % % % % % % % % % % %
% %%%%%%%%% %%%%%%%%%%%%% % % % % % % % %%%%%%% % % %%%%% % % % % % % % % % % % %
% %               %     % % % % % % % %   %   % % % % %   % % %   % % % % % % % %
% %%%%%%%%%%%%%%%%%%%%% % % % % % %%%%%%%%% % %%% %%% % % % % %%% % % % % % % % %
%                     % % % % % % % %     % % % %   %   % % %     % % % % % % % %
% %%%%%%%%%%%%%%%%%%% % % % % %%% % %%%%% % % % % %%%%% %%% % %%%%%%% % % % % % %
%                   % % % % % % % %     % % % %   %     %           % % % % % % %
% % %%%%%%%%%%%%%%% % % % % % % % % %%% % % % % % % %%%%%%%%%%%%%%%%% % % % % % %
% % %             % % % % % % % % % % % % % % % % % %               % % % % % % %
% %%% %%%%%%%%%%% % % % % % % % % % % % % % % % % % % %%%%%%%%%%%%%%% % % % % % %
% %   %         % % % % % % % % % % %   % % % % % % % %               % % % % % %
% % % % %%%%%%% % % % % % % % % % % % %%% % % % % % % % %%%%%%%%%%%%% % % % % % %
% % % % %       % % % % % % % %   % %     % % % % % % % %           % % % % % % %
% % % % % %%%%% % % % % % % % % % % %%%%%%% % % % % % % % %%%%%%%%% % % % % % % %
% % % % % %     % % % % % % % % % %         % % % %   % % %       % % % % % % % %
% % % % % % % %%% %%% % % % % %%% % %%%%%%%%% % % % % %%%%% %%% % % % % % % % % %
% % % % % % %     % % %   % % % % %     %       % % % % % %   % % % % % % % % % %
% % % % % % % %%%%% % % %%% %%% % % %%%%%%%%%%%%%%% % % % %%%%% % % % % % % % % %
% % % % % % %       % % % % % % % % %             % % %         % % % % % % % % %
% % % % % %%% %%%%%%% % % % % % % % % %%%%%%%%%%% % % %%%%%%%%%%% % % % % % % % %
% % % % % % %           % % % % % % %           % % %             % % % % % % % %
% %%% % % % %%%%%%%%%%% % % % % % % % %%%%%%% % % % %%%%%%%%%%%%%%% % %%% % % % %
% % % % % %                     % % %       % % % %   % %   %       % % % % % % %
% % % % % % %%%%%%%%%%%%%%%%%%%%% % % % % % % % % % % % % % %%%%%%% % % % % % % %
% % % % % %                       % % % % % % % % % % % % % %       % % % % % % %
% % % % % %%%%%%%%%%%%%%%%%%%%%%%%% %%%%% % % % %%% % % % %%% %%%%%%% % % % % % %
% % % % %               %           %     % % % % % % % %             % % % % % %
% % % % %%%%%%%%%%%%%%%%%%%%%%%%%%% %%%%% % % % % % % % % %%%%%%%%%%% % % % % % %
% % % %                           %       % % % % % % %   % %       % % % % % % %
% % % %%%%%%%%%%%%%%%%%%%%%%%%%%% %%%%%%%%% % % % % % %%% % % % %%%%% % % % % % %
% % %                   %       %           % % % % % % % % % % %   % % % % % % %
% % % %%%%%%%%%%%%%%%%%%%%%%%%% %%%%%%%%%%%%% % % % % % % % % % % %%% % % % % % %
% % % %           %     % %   %               % %   %     % % % % % % % % % % % %
% % % % %%% %%%%% % %%% % % % %%%%% %%%%%%%%%%% % % %%%%% % % % % % % % % % % % %
% % % %   % %   % % % % % % %         %         % %     % % % % %   % % % % % % %
% % % % %%% %%% % % % % % % %%%%%%%%%%% %%%%%%% % % %%%%% % % % % % %%% % % % % %
% % % % % % % % % % %   % %   %         %       % % %     % % %   % %   % % % % %
% % % % % % % % % %%% % % %%%%%%%%%%%%%%%%%%%%%%% % % % % % % % %%% % % % %%% % %
% % % % % % % % %     % %                         % % % %     %   % % % % % %   %
% % % % % % % % %%%%%%% %%%%%%%%%%%%%%%%%%%%%%%%%%% % %%% %%%%%%% % % % % % % % %
% % % % % % % %                   %   %   %       % %   % %       % % % % % % % %
% % % % % % % %%%%%%%%%%%%%%% % %%%%% % % % %%%%% % % %%%%% % %%%%%%% % % % % % %
%   % % %   %           %     % %     % % % %   % % %   %   % %       % % % % % %
% % % % %%% % %%%%%%%%%%%%%%%%% %%%%% %%% % % %%%%% % %%%%%%% % %%% % % % % % % %
% % % % %   %                                       %   %     % %   % % % % % % %
% % % % %%% %%%%%%%%%%%%%%%%%%%%%%%%%%%%%%%%%%%%%%%%%%%%%%%%%%%%%%% % % % % % % %
% % % % %                                               %           % % % % % % %
% % % % %%%%%%%%%%%%%%%%%%%%%%%%%%%%%%%%%%%%%%%%%%% %%%%%%%%% %%%%%%%%% % % % % %
% % % % %                                                           %   % % % % %
%%% % % %%%%%%%%%%%%%%%%%%%%%%% %%%%%%%%%%%%%%%%%%%%%%%%%%%%%%%%%%%%%%%%% % % % %
% % % %           %                                           %           % % % %
% % % %%%%%%%%%%%%%%%%%%%%%%%%%%%%%%%%%%%%%%%%%%%%%%%%%%%%%%%%%%%%%%%%% %%% % % %
% % %                                                                       % % %
% % %%%%%%%%%%%%%%%%%%%%%%%%%%%%%%%%%%%%%%%%%%%%%%%%%%%%%%%%%%%%%%%%%%%%%%%%% % %
% %           %                                                               % %
% % %%%%%%%%%%%%%%%%%%%%%%%%%%%%%%%%%%%%%%%%%%%%%%%%%%%%%%%%%%%%%%%%%%%%%%%%%%% %
%                                                                      *        %
%%%%%%%%%%%%%%%%%%%%%%%%%%%%%%%%%%%%%%%%%%%%%%%%%%%%%%%%%%%%%%%%%%%%%%%%%%%%%%%%%